object
col 56
row 56
-1 -1 -1 -1 -1 -1 -1 -1 -1 -1 -1 -1 -1 -1 -1 -1 -1 -1 -1 -1 -1 -1 -1 -1 -1 -1 -1 -1 -1 -1 -1 -1 -1 -1 -1 -1 -1 -1 -1 -1 -1 -1 -1 -1 -1 -1 -1 -1 -1 -1 -1 -1 -1 -1 -1 -1 
-1 -1 -1 -1 -1 -1 -1 -1 -1 -1 -1 -1 -1 -1 -1 -1 -1 -1 -1 -1 -1 -1 -1 -1 -1 -1 -1 -1 -1 -1 -1 -1 -1 -1 -1 -1 -1 -1 -1 -1 -1 -1 -1 -1 -1 -1 -1 -1 -1 -1 -1 -1 -1 -1 -1 -1 
-1 -1 -1 -1 -1 -1 -1 -1 -1 106 -1 -1 -1 -1 -1 -1 -1 -1 106 -1 -1 -1 -1 101 -1 -1 -1 106 -1 -1 -1 -1 -1 -1 -1 -1 106 -1 -1 -1 -1 -1 -1 -1 -1 106 -1 -1 -1 -1 -1 -1 -1 -1 -1 -1 
-1 -1 -1 -1 -1 -1 -1 -1 -1 -1 -1 -1 -1 -1 -1 -1 -1 -1 -1 -1 -1 -1 -1 -1 -1 -1 -1 -1 -1 -1 -1 -1 -1 -1 -1 -1 -1 40 40 -1 -1 -1 44 44 44 44 44 44 44 44 44 44 44 -1 -1 -1 
-1 -1 106 -1 -1 -1 -1 -1 -1 -1 -1 93 40 -1 -1 40 -1 -1 40 -1 -1 40 -1 -1 40 -1 -1 40 40 40 -1 -1 40 -1 -1 40 -1 -1 40 -1 -1 -1 92 35 35 35 35 35 35 35 35 35 92 -1 -1 -1 
-1 -1 -1 92 92 -1 50 -1 -1 34 -1 -1 40 60 -1 40 60 -1 40 60 -1 40 60 -1 40 60 -1 40 40 40 60 -1 40 60 -1 40 60 -1 40 -1 -1 -1 34 105 32 -1 -1 -1 -1 -1 -1 32 105 -1 -1 -1 
-1 -1 -1 92 92 -1 50 -1 -1 105 -1 92 40 -1 -1 40 -1 -1 40 -1 -1 40 -1 -1 40 -1 -1 40 40 40 -1 -1 40 -1 -1 40 -1 -1 40 -1 93 -1 34 -1 86 -1 -1 -1 -1 -1 -1 87 96 -1 -1 -1 
-1 -1 -1 -1 -1 -1 -1 -1 -1 35 35 35 34 -1 -1 34 -1 -1 34 -1 -1 34 -1 -1 34 -1 -1 101 -1 101 -1 -1 34 -1 -1 34 -1 -1 34 103 110 -1 34 105 -1 -1 -1 -1 -1 -1 -1 -1 100 -1 -1 -1 
-1 -1 -1 -1 -1 -1 -1 -1 -1 -1 -1 -1 -1 -1 -1 -1 -1 -1 -1 -1 -1 -1 -1 -1 -1 -1 -1 -1 -1 -1 -1 -1 -1 -1 -1 -1 -1 -1 -1 -1 -1 -1 101 -1 86 -1 -1 -1 38 -1 -1 87 96 -1 -1 -1 
-1 -1 -1 -1 -1 -1 -1 -1 -1 -1 -1 93 -1 -1 -1 -1 -1 -1 -1 -1 -1 -1 -1 -1 -1 -1 -1 -1 -1 -1 -1 -1 -1 -1 -1 -1 -1 -1 102 -1 -1 -1 -1 -1 -1 -1 -1 -1 -1 -1 -1 -1 105 -1 -1 -1 
-1 -1 -1 -1 -1 -1 -1 -1 -1 40 40 40 42 42 39 39 40 42 39 39 42 39 40 39 42 39 39 40 42 40 42 39 42 39 42 39 40 42 39 -1 -1 39 92 97 97 97 97 97 97 97 97 97 92 -1 -1 -1 
-1 -1 -1 -1 -1 -1 -1 -1 -1 34 -1 116 -1 118 -1 116 -1 118 -1 116 -1 118 -1 -1 -1 116 -1 -1 118 -1 -1 116 -1 -1 118 -1 -1 -1 -1 -1 -1 -1 -1 -1 40 -1 -1 40 -1 93 -1 40 102 -1 -1 -1 
-1 -1 106 -1 -1 -1 35 -1 -1 -1 -1 -1 -1 -1 -1 -1 -1 -1 -1 -1 -1 -1 -1 -1 -1 -1 -1 -1 -1 -1 -1 -1 -1 -1 -1 -1 -1 -1 39 -1 -1 39 -1 40 -1 -1 40 40 -1 40 -1 -1 37 -1 -1 -1 
-1 -1 -1 -1 -1 40 -1 -1 40 91 97 97 97 97 97 97 97 97 97 97 97 97 97 97 97 97 97 97 97 97 97 97 97 97 97 97 97 97 97 95 95 97 97 97 97 97 91 -1 -1 -1 -1 92 29 -1 -1 -1 
-1 -1 -1 -1 42 -1 -1 93 -1 98 44 -1 35 103 44 26 35 26 44 103 35 -1 44 -1 35 103 44 26 35 26 44 103 35 -1 44 26 35 103 44 -1 -1 26 44 103 35 34 98 -1 -1 -1 42 -1 37 -1 -1 -1 
-1 -1 -1 -1 93 40 41 40 -1 98 -1 -1 -1 -1 -1 -1 -1 -1 -1 -1 -1 -1 -1 -1 -1 -1 -1 -1 -1 -1 -1 -1 -1 -1 -1 -1 -1 -1 -1 -1 -1 -1 -1 -1 -1 44 98 -1 -1 40 -1 -1 37 -1 -1 -1 
-1 -1 27 -1 43 -1 40 -1 -1 98 34 -1 -1 -1 -1 -1 -1 -1 -1 -1 -1 -1 34 -1 -1 -1 -1 -1 -1 -1 -1 -1 -1 -1 -1 -1 -1 -1 -1 -1 -1 -1 -1 -1 -1 27 98 -1 40 -1 -1 43 104 -1 -1 -1 
-1 -1 27 -1 -1 -1 -1 92 40 98 104 -1 -1 -1 -1 -1 -1 -1 -1 -1 -1 -1 27 -1 -1 -1 -1 -1 -1 -1 -1 -1 -1 -1 -1 -1 -1 -1 -1 -1 -1 -1 -1 -1 -1 34 98 92 -1 -1 41 -1 -1 -1 -1 -1 
-1 -1 -1 -1 -1 41 40 -1 -1 98 44 -1 -1 -1 -1 -1 -1 -1 -1 -1 -1 -1 39 -1 -1 -1 -1 -1 -1 -1 -1 -1 -1 -1 -1 -1 -1 -1 -1 -1 -1 -1 -1 -1 -1 27 98 40 -1 -1 92 -1 40 -1 -1 -1 
-1 -1 -1 -1 42 -1 -1 -1 40 98 27 -1 -1 -1 -1 -1 -1 -1 -1 -1 -1 -1 34 -1 -1 -1 -1 -1 -1 -1 -1 -1 -1 -1 -1 -1 -1 -1 -1 -1 -1 -1 -1 -1 -1 44 98 -1 -1 -1 42 -1 93 -1 -1 -1 
-1 -1 -1 -1 -1 -1 43 -1 40 98 27 -1 -1 -1 -1 -1 -1 -1 -1 -1 -1 -1 -1 -1 -1 -1 -1 -1 -1 -1 -1 -1 -1 -1 -1 -1 -1 -1 -1 -1 -1 -1 -1 -1 -1 34 98 92 -1 40 92 -1 40 -1 -1 -1 
-1 -1 106 -1 -1 -1 -1 -1 -1 98 93 -1 -1 -1 -1 -1 -1 35 -1 35 -1 35 39 -1 -1 -1 -1 -1 -1 35 44 35 44 35 44 35 44 35 44 -1 -1 -1 -1 -1 -1 100 96 -1 -1 -1 -1 -1 -1 106 -1 -1 
-1 -1 -1 -1 -1 -1 -1 -1 -1 96 -1 -1 -1 -1 -1 -1 -1 -1 -1 -1 -1 -1 -1 -1 -1 -1 -1 -1 -1 -1 -1 -1 -1 -1 -1 -1 -1 -1 -1 -1 -1 -1 -1 -1 -1 -1 96 -1 -1 -1 -1 -1 -1 -1 -1 -1 
-1 -1 -1 -1 -1 -1 -1 -1 -1 96 -1 -1 -1 -1 -1 -1 -1 -1 -1 -1 -1 -1 -1 -1 -1 -1 -1 -1 -1 -1 -1 -1 -1 -1 -1 -1 -1 -1 -1 -1 -1 -1 -1 -1 -1 -1 96 -1 -1 -1 -1 -1 -1 -1 -1 -1 
-1 -1 -1 -1 -1 -1 -1 -1 -1 98 44 -1 -1 -1 -1 -1 -1 -1 -1 -1 -1 -1 102 -1 -1 -1 -1 -1 -1 33 26 26 -1 42 42 -1 26 26 40 -1 -1 -1 -1 -1 -1 100 96 -1 -1 -1 -1 -1 -1 -1 -1 -1 
-1 -1 32 -1 -1 42 92 41 -1 98 104 -1 -1 -1 -1 -1 -1 87 -1 -1 -1 88 -1 -1 -1 -1 -1 -1 -1 34 -1 -1 -1 -1 -1 -1 -1 -1 -1 -1 -1 -1 -1 -1 -1 44 98 -1 40 -1 41 92 40 102 -1 -1 
-1 -1 102 93 42 -1 41 -1 -1 98 34 -1 -1 -1 -1 -1 -1 87 98 108 -1 -1 35 -1 -1 -1 -1 -1 -1 -1 -1 -1 -1 -1 -1 -1 -1 -1 34 -1 -1 -1 -1 -1 -1 27 98 -1 92 43 -1 42 -1 32 -1 -1 
-1 -1 -1 -1 -1 -1 -1 -1 -1 98 -1 -1 -1 -1 -1 -1 -1 106 -1 32 -1 -1 106 -1 -1 -1 -1 -1 -1 106 36 40 97 35 97 36 40 97 106 -1 -1 -1 -1 -1 -1 100 96 -1 -1 -1 -1 -1 -1 -1 -1 -1 
-1 -1 -1 -1 -1 -1 -1 -1 -1 96 -1 -1 -1 -1 -1 -1 -1 -1 -1 -1 -1 -1 -1 -1 -1 -1 -1 -1 -1 -1 -1 -1 -1 -1 -1 -1 -1 -1 -1 -1 -1 -1 -1 -1 -1 -1 96 -1 -1 -1 -1 -1 -1 -1 -1 -1 
-1 -1 -1 -1 -1 -1 -1 -1 -1 96 -1 -1 -1 -1 -1 -1 -1 -1 -1 -1 -1 -1 -1 -1 -1 -1 -1 -1 -1 -1 -1 -1 -1 -1 -1 -1 -1 -1 -1 -1 -1 -1 -1 -1 -1 -1 96 -1 -1 -1 -1 -1 -1 -1 -1 -1 
-1 -1 106 -1 -1 -1 -1 -1 -1 98 44 -1 -1 -1 -1 -1 -1 106 29 -1 -1 -1 106 -1 -1 -1 -1 -1 -1 106 35 97 35 97 35 97 35 97 106 -1 -1 -1 -1 -1 -1 100 96 -1 -1 -1 -1 -1 -1 106 -1 -1 
-1 -1 -1 -1 -1 -1 -1 40 40 98 104 -1 -1 -1 -1 -1 -1 34 -1 -1 -1 -1 34 -1 -1 -1 -1 -1 -1 -1 39 -1 -1 -1 -1 -1 -1 -1 33 -1 -1 -1 -1 -1 -1 44 98 -1 -1 41 -1 -1 39 -1 -1 -1 
-1 -1 -1 -1 41 -1 41 41 -1 98 34 -1 -1 -1 -1 -1 -1 92 -1 -1 -1 -1 -1 -1 -1 -1 -1 -1 -1 34 -1 -1 -1 -1 -1 -1 -1 -1 -1 -1 -1 -1 -1 -1 -1 27 98 -1 41 -1 -1 -1 -1 -1 -1 -1 
-1 -1 -1 -1 93 41 -1 -1 -1 98 27 -1 -1 -1 -1 -1 -1 -1 32 -1 -1 -1 93 -1 -1 -1 -1 -1 -1 -1 34 -1 -1 94 -1 -1 -1 31 -1 -1 -1 -1 -1 -1 -1 34 98 -1 -1 -1 39 61 -1 -1 -1 -1 
-1 -1 27 -1 -1 -1 -1 111 -1 98 44 -1 -1 -1 -1 -1 -1 34 43 -1 38 -1 43 -1 -1 -1 -1 -1 -1 34 39 -1 -1 91 32 110 -1 -1 -1 -1 -1 -1 -1 -1 -1 27 98 -1 -1 -1 -1 -1 39 37 -1 -1 
-1 -1 27 -1 40 40 -1 42 -1 98 27 -1 -1 -1 -1 -1 -1 -1 -1 -1 -1 -1 -1 -1 -1 -1 -1 -1 -1 -1 34 104 -1 -1 -1 -1 -1 -1 -1 -1 -1 -1 -1 -1 -1 34 98 -1 -1 -1 -1 -1 39 37 -1 -1 
-1 -1 -1 -1 40 92 -1 -1 -1 98 34 -1 -1 -1 -1 -1 -1 -1 -1 -1 -1 -1 -1 -1 -1 -1 -1 -1 -1 34 27 -1 -1 -1 -1 -1 -1 -1 -1 -1 -1 -1 -1 -1 -1 45 98 -1 -1 41 -1 -1 -1 -1 -1 -1 
-1 -1 -1 -1 -1 -1 -1 111 -1 98 104 -1 -1 -1 -1 -1 -1 -1 -1 -1 -1 -1 -1 -1 -1 -1 -1 -1 -1 -1 39 -1 -1 -1 -1 -1 -1 -1 -1 -1 -1 -1 -1 -1 -1 34 98 -1 -1 -1 39 61 -1 -1 -1 -1 
-1 -1 -1 40 -1 -1 41 -1 -1 98 44 -1 -1 -1 -1 -1 -1 -1 -1 -1 -1 -1 -1 -1 -1 -1 -1 -1 -1 34 27 -1 -1 -1 -1 -1 -1 -1 -1 -1 -1 -1 -1 -1 -1 27 98 -1 -1 -1 -1 -1 39 32 -1 -1 
-1 -1 106 -1 -1 40 -1 -1 93 98 -1 -1 -1 -1 -1 -1 -1 -1 -1 -1 -1 -1 -1 -1 -1 -1 -1 -1 -1 -1 34 -1 -1 -1 -1 -1 -1 -1 -1 -1 -1 -1 -1 -1 -1 44 98 -1 -1 41 -1 -1 39 106 -1 -1 
-1 -1 -1 -1 -1 -1 -1 -1 40 98 34 -1 -1 -1 -1 -1 -1 -1 -1 -1 -1 -1 -1 -1 -1 -1 -1 -1 -1 -1 -1 104 -1 -1 -1 -1 -1 -1 -1 -1 -1 -1 -1 -1 -1 34 98 -1 -1 -1 -1 -1 -1 -1 -1 -1 
-1 -1 -1 -1 40 -1 40 -1 40 98 -1 44 -1 35 26 44 -1 35 26 44 -1 35 -1 44 26 35 -1 44 26 35 -1 44 -1 35 26 44 -1 35 26 44 -1 35 26 44 -1 34 98 -1 -1 -1 39 61 -1 -1 -1 -1 
-1 -1 -1 -1 -1 93 -1 -1 -1 91 97 97 97 97 97 97 97 97 97 97 97 97 97 97 97 97 97 97 97 97 97 97 97 97 97 97 97 97 97 97 97 97 97 97 97 97 91 -1 -1 -1 -1 -1 39 -1 -1 -1 
-1 -1 -1 -1 -1 -1 -1 -1 -1 -1 -1 -1 -1 40 -1 -1 -1 -1 40 -1 -1 -1 -1 -1 -1 -1 -1 -1 -1 -1 -1 -1 -1 -1 -1 -1 -1 -1 -1 -1 -1 -1 -1 -1 -1 -1 -1 -1 -1 41 -1 -1 39 -1 -1 -1 
-1 -1 -1 -1 42 42 -1 43 43 -1 40 -1 -1 -1 -1 -1 -1 -1 -1 -1 40 -1 -1 40 -1 40 118 -1 118 -1 118 -1 118 -1 118 -1 -1 -1 -1 -1 -1 -1 -1 -1 -1 -1 41 -1 41 -1 -1 -1 -1 -1 -1 -1 
-1 -1 -1 -1 -1 -1 -1 40 -1 -1 -1 -1 92 -1 -1 -1 40 -1 41 -1 -1 -1 93 -1 -1 40 -1 -1 -1 -1 -1 -1 -1 -1 -1 -1 -1 -1 -1 39 39 39 39 39 39 41 92 -1 -1 -1 39 61 -1 32 -1 -1 
-1 -1 -1 -1 -1 42 -1 -1 -1 -1 -1 -1 -1 -1 43 -1 93 -1 -1 41 -1 41 -1 -1 -1 -1 -1 -1 -1 -1 -1 -1 -1 -1 -1 -1 -1 -1 -1 39 -1 -1 -1 -1 39 -1 -1 -1 -1 -1 -1 -1 39 -1 -1 -1 
-1 -1 -1 -1 -1 -1 92 41 -1 40 -1 41 -1 -1 -1 43 -1 -1 -1 -1 -1 -1 -1 -1 43 43 -1 41 -1 -1 -1 -1 -1 -1 -1 93 -1 92 -1 39 113 -1 113 -1 39 41 41 -1 41 -1 -1 -1 39 -1 -1 -1 
-1 -1 106 -1 -1 -1 41 -1 -1 -1 -1 -1 42 -1 42 -1 -1 -1 -1 40 92 40 -1 41 -1 -1 -1 -1 -1 -1 40 -1 40 40 -1 -1 -1 -1 -1 39 31 -1 -1 -1 39 -1 -1 42 -1 -1 39 -1 -1 106 -1 -1 
-1 -1 -1 -1 93 -1 -1 -1 -1 40 -1 92 -1 -1 -1 -1 -1 -1 41 -1 -1 -1 -1 41 -1 -1 41 -1 41 -1 40 -1 92 -1 -1 -1 40 -1 -1 41 34 -1 -1 -1 -1 41 -1 -1 42 -1 39 61 -1 -1 -1 -1 
-1 -1 -1 -1 -1 -1 42 -1 -1 -1 -1 41 -1 -1 -1 -1 -1 93 -1 -1 42 -1 -1 -1 -1 92 -1 -1 -1 -1 -1 42 -1 -1 -1 42 -1 -1 42 -1 34 -1 -1 -1 -1 -1 93 40 -1 -1 -1 39 39 -1 -1 -1 
-1 -1 -1 -1 -1 -1 -1 -1 93 -1 -1 -1 -1 -1 42 42 -1 -1 -1 -1 42 -1 -1 93 -1 -1 -1 -1 -1 -1 -1 -1 -1 -1 40 -1 93 42 -1 -1 34 -1 -1 -1 -1 41 -1 -1 -1 -1 41 -1 39 -1 -1 -1 
-1 -1 -1 -1 -1 -1 -1 -1 -1 -1 -1 -1 -1 -1 -1 -1 -1 -1 -1 -1 -1 -1 -1 -1 -1 50 -1 -1 50 -1 50 -1 -1 -1 28 36 36 32 36 36 34 -1 -1 -1 -1 39 39 39 39 39 39 39 39 -1 -1 -1 
-1 -1 -1 -1 -1 106 -1 -1 -1 -1 -1 -1 -1 -1 106 -1 -1 -1 -1 -1 -1 -1 -1 106 -1 -1 -1 101 -1 -1 -1 -1 106 -1 -1 -1 -1 -1 -1 -1 -1 106 -1 -1 -1 -1 -1 -1 -1 -1 106 -1 -1 -1 -1 -1 
-1 -1 -1 -1 -1 -1 -1 -1 -1 -1 -1 -1 -1 -1 -1 -1 -1 -1 -1 -1 -1 -1 -1 -1 -1 -1 -1 -1 -1 -1 -1 -1 -1 -1 -1 -1 -1 -1 -1 -1 -1 -1 -1 -1 -1 -1 -1 -1 -1 -1 -1 -1 -1 -1 -1 -1 
-1 -1 -1 -1 -1 -1 -1 -1 -1 -1 -1 -1 -1 -1 -1 -1 -1 -1 -1 -1 -1 -1 -1 -1 -1 -1 -1 -1 -1 -1 -1 -1 -1 -1 -1 -1 -1 -1 -1 -1 -1 -1 -1 -1 -1 -1 -1 -1 -1 -1 -1 -1 -1 -1 -1 -1 
