tile
col 56
row 56
3 3 3 3 3 3 3 3 3 3 3 3 3 3 3 3 3 3 3 3 3 3 3 3 3 3 3 2 2 2 2 2 2 2 2 2 2 2 2 2 2 2 2 2 3 -1 -1 3 2 2 2 2 2 2 2 2 
6 6 6 6 6 6 6 6 6 6 6 6 6 6 6 6 6 3 3 3 3 3 3 3 3 3 3 2 2 2 2 2 2 2 2 2 2 2 2 2 2 2 2 2 3 7 -1 3 2 2 2 2 2 2 2 2 
6 3 3 3 3 6 3 3 3 3 3 3 3 3 3 3 6 3 3 3 3 3 3 3 3 3 3 2 2 2 2 2 2 2 2 2 2 2 2 2 2 2 2 2 3 -1 -1 3 2 2 2 2 2 2 2 2 
6 3 3 3 3 6 3 3 3 3 3 3 3 3 3 3 6 3 3 3 3 3 3 3 3 3 3 2 2 2 2 2 2 2 2 2 2 2 2 2 2 2 2 2 3 7 -1 3 2 2 2 2 2 2 2 2 
6 3 3 3 3 6 3 3 3 3 3 3 3 3 3 3 3 3 3 3 3 3 3 3 3 3 3 2 2 2 2 2 2 2 2 2 2 2 2 2 2 2 2 2 3 -1 -1 3 2 2 2 2 2 2 2 2 
6 3 3 3 3 6 3 3 3 3 3 3 3 3 3 3 6 3 6 6 6 6 6 6 6 6 3 2 2 2 2 2 2 2 2 2 2 2 2 2 2 2 2 2 3 7 -1 3 3 3 3 3 3 3 3 3 
6 3 3 3 3 6 3 3 3 3 3 3 3 3 3 3 6 3 6 6 6 6 6 6 6 6 3 2 2 2 2 2 2 2 2 2 2 2 2 2 2 2 2 2 3 -1 -1 -1 -1 -1 -1 -1 -1 -1 -1 -1 
6 6 6 6 6 6 6 6 6 6 6 6 6 6 6 6 6 3 6 6 6 3 3 6 6 6 3 2 2 2 2 2 2 2 2 2 2 2 2 2 2 2 2 2 3 10 -1 8 -1 8 -1 8 -1 8 -1 8 
6 6 6 6 6 6 6 6 3 3 3 3 3 3 3 3 3 3 6 6 6 3 3 6 6 6 3 3 3 3 3 3 3 3 3 3 3 3 3 3 3 3 3 3 3 3 3 3 3 3 3 3 3 3 3 3 
6 6 6 6 6 6 6 6 3 6 6 6 6 6 6 6 6 6 6 6 6 3 3 6 6 6 6 6 6 6 6 6 6 6 6 6 6 6 6 6 6 6 6 6 6 6 6 3 6 6 6 6 6 3 3 3 
6 6 6 6 6 6 6 6 3 6 3 3 3 3 3 3 3 3 3 3 3 4 4 3 3 3 3 3 3 3 2 2 2 2 6 6 6 6 6 6 6 6 6 6 6 6 6 3 6 6 6 6 6 3 3 3 
6 6 6 6 6 6 6 6 3 6 3 -1 -1 -1 -1 -1 -1 -1 -1 -1 -1 -1 -1 -1 -1 -1 -1 -1 -1 3 2 2 2 2 6 2 2 2 2 2 2 2 2 2 6 6 6 3 6 6 6 6 6 3 3 3 
6 6 6 6 6 6 6 6 3 6 3 9 -1 8 -1 8 -1 8 -1 8 -1 14 -1 8 -1 8 -1 12 -1 3 2 2 2 2 6 2 2 2 2 2 2 2 2 2 6 6 6 3 6 6 6 6 6 3 3 3 
6 6 6 6 6 6 6 6 3 6 3 -1 -1 3 3 3 3 3 3 3 3 3 3 3 3 3 3 -1 -1 3 2 2 2 2 6 6 6 2 2 2 2 2 2 2 6 6 6 3 6 3 3 3 3 3 3 3 
6 6 6 6 6 6 6 6 3 6 3 7 -1 3 2 2 2 2 2 2 2 2 2 2 2 2 3 7 -1 3 6 2 2 2 6 6 6 2 2 3 3 2 2 6 6 6 6 3 6 3 3 3 3 3 -1 -1 
6 6 6 6 6 6 6 6 3 6 3 -1 -1 3 2 2 2 2 2 2 2 2 2 2 2 2 3 -1 -1 3 6 2 2 2 2 2 2 2 6 3 3 2 2 6 6 6 6 3 6 3 3 3 3 3 9 -1 
6 6 6 6 6 6 6 6 3 6 3 7 -1 3 2 2 6 2 2 2 2 2 2 6 2 2 3 7 -1 3 6 2 2 2 2 2 2 6 6 3 3 2 2 6 6 6 6 3 6 3 3 3 3 3 24 -1 
6 6 6 6 6 6 6 6 3 6 3 -1 -1 3 2 2 6 2 2 2 2 2 2 6 2 2 3 -1 -1 3 6 6 6 6 6 2 2 6 6 3 3 2 2 6 6 6 6 3 6 6 6 6 6 3 24 -1 
6 6 6 6 6 6 6 6 3 6 3 7 -1 3 2 2 6 2 2 2 2 2 2 6 2 2 3 7 -1 3 3 3 3 6 6 2 2 2 2 2 2 2 2 6 6 6 6 3 6 6 6 6 6 3 -1 -1 
6 6 6 6 6 6 6 6 3 6 3 -1 -1 3 2 2 2 2 2 2 2 2 2 2 2 2 3 -1 -1 3 3 3 3 6 6 2 2 2 2 2 2 2 2 6 6 6 6 3 6 3 3 3 3 3 7 -1 
6 6 6 6 6 6 6 6 3 6 3 7 -1 3 2 2 6 2 2 2 2 2 2 6 2 2 3 7 -1 3 3 3 3 6 6 6 6 6 6 2 2 3 3 3 3 3 6 3 6 3 3 3 3 3 -1 -1 
6 6 6 6 6 6 6 6 3 6 3 -1 -1 3 2 2 6 2 2 2 2 2 2 6 2 2 3 24 -1 3 3 3 3 6 6 6 6 6 3 -1 -1 -1 -1 -1 -1 3 6 3 6 3 3 3 3 3 7 -1 
6 6 6 6 6 6 6 6 3 6 3 7 -1 3 2 2 6 2 2 2 2 2 2 6 2 2 3 24 -1 3 3 3 3 6 6 6 6 6 3 10 -1 8 -1 12 -1 3 6 3 6 3 3 3 3 3 -1 -1 
6 6 6 6 6 6 6 6 3 6 3 -1 -1 3 2 2 6 2 2 2 2 2 2 6 2 2 3 -1 -1 3 3 3 3 3 3 3 3 3 3 3 3 3 3 -1 -1 3 6 3 6 3 3 3 3 3 7 -1 
6 6 6 6 6 6 6 6 3 6 3 7 -1 3 2 2 2 2 2 2 2 2 2 2 2 2 3 7 -1 3 3 3 3 3 3 3 3 3 3 3 3 3 3 7 -1 3 6 3 6 3 3 3 3 3 -1 -1 
6 6 6 6 6 6 6 6 3 6 3 -1 -1 3 2 2 2 2 2 2 2 2 2 2 2 2 3 -1 -1 3 3 3 3 3 3 3 3 3 3 3 3 3 3 -1 -1 3 6 3 6 6 6 6 6 3 7 -1 
6 6 6 6 6 6 6 6 3 6 3 7 -1 3 3 3 3 3 3 3 3 3 3 3 3 3 3 7 -1 3 3 3 3 3 3 3 3 3 3 3 3 3 3 7 -1 3 6 3 6 6 6 6 6 3 -1 -1 
6 6 6 6 6 6 6 6 3 6 3 -1 -1 3 3 3 3 3 3 3 3 3 3 3 3 3 3 -1 -1 -1 -1 -1 -1 -1 -1 -1 -1 -1 -1 -1 -1 -1 -1 -1 -1 3 6 3 6 3 3 3 3 3 7 -1 
6 6 6 6 6 6 6 6 3 6 3 7 -1 3 3 3 3 3 3 3 3 3 3 3 3 3 3 16 -1 8 -1 8 -1 8 -1 8 -1 8 -1 25 25 8 -1 11 -1 3 6 3 6 3 3 3 3 3 -1 -1 
6 6 6 6 6 6 6 6 3 6 3 -1 -1 3 6 6 6 6 6 3 3 6 6 6 6 6 3 -1 -1 3 3 3 3 3 3 3 3 3 3 3 3 3 3 3 3 3 6 3 6 3 3 3 3 3 7 -1 
6 6 6 6 6 6 6 6 3 6 3 7 -1 3 6 3 3 3 3 3 3 3 3 3 3 6 3 7 -1 3 3 3 3 3 3 3 3 3 3 3 3 3 3 3 3 3 6 3 6 3 3 3 3 3 -1 -1 
6 6 6 6 6 6 6 6 3 6 3 -1 -1 3 6 3 3 3 3 3 3 3 3 3 3 6 3 -1 -1 3 3 6 6 6 6 6 6 6 6 6 6 6 6 3 3 3 6 3 6 3 3 3 3 3 7 -1 
6 6 6 6 6 6 6 6 3 6 3 7 -1 3 6 3 3 3 3 3 3 3 3 3 3 6 3 7 -1 3 3 6 6 6 6 6 6 6 6 6 6 6 6 3 3 3 6 3 6 3 3 3 3 3 -1 -1 
6 6 6 6 3 3 6 6 3 6 3 -1 -1 3 6 3 3 6 6 6 6 6 3 3 3 6 3 -1 -1 3 3 6 6 6 6 6 6 6 6 6 6 6 6 3 3 3 6 3 6 3 3 3 3 3 7 -1 
6 6 6 6 3 3 6 6 3 6 3 7 -1 3 6 3 3 6 6 6 6 6 3 3 3 6 3 7 -1 3 3 6 6 6 6 6 6 6 6 6 6 6 6 3 3 3 6 3 6 6 6 6 6 3 -1 -1 
3 3 3 3 3 3 3 3 3 6 3 24 -1 3 3 3 3 6 6 6 6 6 3 3 3 3 3 24 -1 3 3 6 6 6 6 6 6 6 6 6 6 6 6 3 3 3 6 3 6 6 6 6 6 3 7 -1 
-1 -1 -1 -1 -1 -1 -1 -1 3 6 3 24 -1 3 3 3 3 6 6 6 6 6 3 3 3 3 3 24 -1 3 3 6 6 6 6 6 6 6 6 6 6 6 6 3 3 3 6 3 6 3 3 3 3 3 -1 -1 
8 -1 8 -1 8 -1 12 -1 3 6 3 -1 -1 3 6 3 3 6 6 6 6 6 3 3 3 6 3 -1 -1 3 3 6 6 6 6 6 6 6 6 6 6 6 6 3 3 3 6 3 6 3 3 3 3 3 7 -1 
3 3 3 3 3 3 -1 -1 3 6 3 7 -1 3 6 3 3 3 3 3 3 3 3 3 3 6 3 7 -1 3 3 6 6 6 6 6 6 6 6 6 6 6 6 3 3 3 6 3 6 3 3 3 3 3 -1 -1 
6 6 6 6 6 3 7 -1 3 6 3 -1 -1 3 6 3 3 3 3 3 3 3 3 3 3 6 3 -1 -1 3 3 6 6 6 6 6 6 6 6 6 6 6 6 3 3 3 6 3 6 3 3 3 3 3 7 -1 
6 6 6 6 6 3 -1 -1 3 6 3 7 -1 3 6 3 3 3 3 3 3 3 3 3 3 6 3 7 -1 3 3 6 6 6 6 6 6 6 6 6 6 6 6 3 3 3 6 3 6 3 3 3 3 3 -1 -1 
6 3 3 3 3 3 7 -1 3 6 3 -1 -1 3 6 6 6 6 6 3 3 6 6 6 6 6 3 -1 -1 3 3 6 6 2 2 2 2 2 2 2 2 6 6 3 3 3 6 3 6 6 6 6 6 3 7 -1 
6 3 3 3 3 3 -1 -1 3 6 3 7 -1 3 3 3 3 3 3 3 3 3 3 3 3 3 3 7 -1 3 3 2 2 2 2 2 2 2 2 2 2 2 2 3 3 3 6 3 6 6 6 6 6 3 -1 -1 
6 3 3 3 3 3 7 -1 3 6 3 -1 -1 -1 -1 -1 -1 -1 -1 -1 -1 -1 -1 -1 -1 -1 -1 -1 -1 3 3 2 2 2 2 2 2 2 2 2 2 2 2 3 3 3 6 3 6 3 3 3 3 3 7 -1 
6 3 3 3 3 3 -1 -1 3 6 3 10 -1 8 -1 8 -1 8 -1 25 25 8 -1 8 -1 8 -1 11 -1 3 3 3 3 3 3 3 3 3 3 3 3 3 3 3 3 3 6 3 6 3 3 3 3 3 -1 -1 
6 3 3 3 3 3 7 -1 3 6 3 3 3 3 3 3 3 3 3 3 3 3 3 3 3 3 3 3 3 3 3 3 3 3 3 3 3 3 3 3 3 3 3 3 3 3 6 3 6 3 3 3 3 3 7 -1 
6 6 6 6 6 3 24 -1 3 6 6 6 6 6 6 6 6 6 6 6 6 6 6 6 6 6 6 6 6 6 6 6 6 6 6 6 6 6 6 6 6 6 6 6 6 6 6 3 6 6 6 6 6 3 -1 -1 
6 6 6 6 6 3 24 -1 3 3 3 3 3 3 3 3 3 3 3 3 3 3 3 3 3 3 3 3 3 3 3 3 3 3 3 3 3 3 3 3 3 3 3 3 3 3 3 3 3 3 3 3 3 3 7 -1 
6 6 3 3 3 3 -1 -1 3 3 3 3 3 3 3 3 3 3 3 3 3 3 3 3 3 3 3 3 3 3 3 3 3 3 3 3 3 3 3 3 3 3 3 3 3 3 3 3 3 3 3 3 3 3 -1 -1 
6 6 3 3 3 3 7 -1 3 3 3 3 3 3 3 3 3 3 3 3 3 3 3 2 2 2 2 2 2 3 3 3 3 3 3 3 3 3 3 3 3 3 3 3 3 3 3 3 3 3 3 3 3 3 7 -1 
6 6 6 6 6 3 -1 -1 3 3 3 3 3 3 3 3 3 3 3 3 3 3 3 2 6 6 6 6 2 3 -1 -1 -1 -1 -1 -1 -1 -1 -1 -1 -1 -1 -1 -1 -1 -1 -1 -1 -1 -1 -1 -1 -1 -1 -1 -1 
6 6 6 6 6 3 7 -1 3 3 3 3 3 3 3 3 3 3 3 3 3 3 3 2 6 6 6 6 2 3 9 -1 8 -1 8 -1 8 -1 8 -1 8 -1 8 -1 8 -1 8 -1 8 -1 8 -1 8 -1 11 -1 
6 6 6 6 6 3 -1 -1 -1 -1 -1 -1 -1 -1 -1 -1 -1 -1 -1 -1 3 -1 3 2 6 6 6 6 2 3 -1 -1 3 3 3 3 3 3 3 3 3 3 3 3 3 3 3 3 3 3 3 3 3 3 3 3 
6 6 6 6 6 3 10 -1 8 -1 8 -1 8 -1 8 -1 8 -1 8 -1 12 -1 3 2 6 6 6 6 2 3 7 -1 3 3 3 3 3 3 3 3 3 3 3 3 3 3 3 3 3 3 3 3 3 3 3 3 
6 6 6 6 6 3 3 3 3 3 3 3 3 3 3 3 3 3 3 3 -1 -1 3 2 6 6 6 6 2 3 -1 -1 3 3 3 3 3 3 3 3 3 3 3 3 3 3 3 3 3 3 3 3 3 3 3 3 
6 6 6 6 6 3 3 3 3 3 3 3 3 3 3 3 3 3 3 3 7 -1 3 2 2 2 2 2 2 3 7 -1 3 6 6 6 6 6 6 6 6 6 6 6 6 6 6 6 6 6 6 6 6 6 6 6 
