tile
col 36
row 36
-1 -1 -1 -1 -1 -1 -1 -1 -1 -1 -1 -1 -1 -1 -1 -1 -1 -1 -1 -1 -1 -1 -1 -1 -1 -1 -1 -1 -1 -1 -1 -1 -1 -1 -1 -1 
-1 -1 -1 -1 -1 -1 -1 -1 -1 -1 -1 -1 -1 -1 -1 -1 -1 -1 -1 -1 -1 -1 -1 -1 -1 -1 -1 -1 -1 -1 -1 -1 -1 -1 -1 -1 
-1 -1 -1 -1 -1 -1 -1 -1 -1 -1 -1 -1 -1 -1 -1 -1 -1 -1 -1 -1 -1 -1 -1 -1 -1 -1 -1 -1 -1 -1 -1 -1 -1 -1 -1 -1 
-1 -1 -1 -1 -1 -1 -1 -1 -1 -1 -1 -1 -1 -1 -1 -1 -1 -1 -1 -1 -1 -1 -1 -1 -1 -1 -1 -1 -1 -1 -1 -1 -1 -1 -1 -1 
-1 -1 -1 -1 -1 -1 -1 -1 -1 -1 -1 -1 -1 -1 -1 -1 -1 -1 -1 -1 -1 -1 -1 -1 -1 -1 -1 -1 -1 -1 -1 -1 -1 -1 -1 -1 
-1 -1 -1 -1 -1 -1 -1 -1 -1 -1 -1 -1 -1 -1 -1 -1 -1 -1 -1 -1 -1 -1 -1 -1 -1 -1 -1 -1 -1 -1 -1 -1 -1 -1 -1 -1 
-1 -1 -1 -1 -1 -1 -1 -1 -1 -1 -1 -1 -1 -1 -1 -1 -1 -1 -1 -1 -1 -1 -1 -1 -1 -1 -1 -1 -1 -1 -1 -1 -1 -1 -1 -1 
-1 -1 -1 -1 -1 -1 -1 -1 -1 -1 -1 -1 -1 -1 -1 -1 -1 -1 -1 -1 -1 -1 -1 -1 -1 -1 -1 -1 -1 -1 -1 -1 -1 -1 -1 -1 
-1 -1 -1 -1 -1 -1 -1 -1 -1 -1 -1 -1 -1 -1 -1 -1 -1 -1 -1 -1 -1 -1 -1 -1 -1 -1 -1 -1 -1 -1 -1 -1 -1 -1 -1 -1 
-1 -1 -1 -1 -1 -1 -1 -1 -1 -1 -1 -1 -1 -1 -1 -1 -1 -1 -1 -1 -1 -1 -1 -1 -1 -1 -1 -1 -1 -1 -1 -1 -1 -1 -1 -1 
6 6 6 6 6 6 6 6 6 6 6 6 6 6 6 6 6 6 6 6 6 6 6 6 6 6 6 6 6 6 6 6 6 6 6 6 
6 -1 -1 -1 -1 -1 -1 -1 -1 -1 -1 -1 -1 -1 6 3 3 -1 -1 -1 -1 -1 -1 -1 6 -1 -1 -1 -1 -1 -1 -1 -1 -1 -1 6 
6 9 -1 8 -1 8 -1 8 25 25 8 -1 12 -1 6 6 3 9 -1 8 8 -1 12 -1 6 9 -1 8 -1 8 -1 8 -1 12 -1 6 
6 -1 -1 6 6 6 6 3 3 3 6 6 -1 -1 6 3 3 -1 -1 3 3 3 -1 -1 6 3 3 6 6 6 6 6 6 -1 -1 6 
6 7 -1 6 6 6 6 3 3 3 3 6 7 -1 6 3 3 7 -1 3 6 3 7 -1 6 3 3 3 3 3 3 3 6 7 -1 6 
6 -1 -1 6 3 3 3 3 3 3 3 6 -1 -1 3 6 3 -1 -1 3 6 3 24 -1 3 3 3 3 3 3 3 3 6 -1 -1 6 
6 7 -1 3 3 3 3 3 3 3 3 6 7 -1 3 6 3 7 -1 3 6 3 24 -1 3 3 3 3 3 6 6 3 3 7 -1 6 
6 -1 -1 3 3 3 6 6 6 6 3 6 -1 -1 3 6 3 -1 -1 3 6 3 -1 -1 6 3 3 6 6 6 6 3 3 -1 -1 6 
6 7 -1 3 3 3 6 6 6 6 3 6 7 -1 3 6 3 7 -1 3 6 3 7 -1 6 3 3 6 6 6 6 3 6 7 -1 6 
6 -1 -1 3 3 6 6 6 6 6 3 6 -1 -1 3 6 3 -1 -1 3 6 3 -1 -1 6 3 3 3 6 6 6 3 6 -1 -1 6 
6 7 -1 3 3 3 3 3 3 3 3 6 7 -1 6 6 3 7 -1 3 6 3 7 -1 6 6 3 3 3 3 3 3 6 7 -1 6 
6 -1 -1 3 3 3 3 3 3 3 3 6 -1 -1 3 6 3 -1 -1 3 6 3 -1 -1 6 6 3 3 3 3 3 3 3 -1 -1 6 
6 7 -1 6 6 6 6 6 6 3 3 6 7 -1 3 3 3 7 -1 3 6 3 7 -1 6 6 6 6 6 6 6 3 3 7 -1 6 
6 -1 -1 -1 -1 -1 -1 -1 -1 -1 -1 6 -1 -1 -1 -1 -1 -1 -1 3 6 3 -1 -1 -1 -1 -1 -1 -1 -1 -1 -1 -1 -1 -1 6 
6 10 -1 8 -1 8 -1 8 -1 11 -1 6 10 -1 8 8 -1 11 -1 3 6 6 10 -1 8 -1 8 -1 8 8 -1 25 25 11 -1 6 
6 6 6 6 6 6 6 6 6 6 6 6 6 6 6 6 6 6 6 6 6 6 6 6 6 6 6 6 6 6 6 6 6 6 6 6 
-1 -1 -1 -1 -1 -1 -1 -1 -1 -1 -1 -1 -1 -1 -1 -1 -1 -1 -1 -1 -1 -1 -1 -1 -1 -1 -1 -1 -1 -1 -1 -1 -1 -1 -1 -1 
-1 -1 -1 -1 -1 -1 -1 -1 -1 -1 -1 -1 -1 -1 -1 -1 -1 -1 -1 -1 -1 -1 -1 -1 -1 -1 -1 -1 -1 -1 -1 -1 -1 -1 -1 -1 
-1 -1 -1 -1 -1 -1 -1 -1 -1 -1 -1 -1 -1 -1 -1 -1 -1 -1 -1 -1 -1 -1 -1 -1 -1 -1 -1 -1 -1 -1 -1 -1 -1 -1 -1 -1 
-1 -1 -1 -1 -1 -1 -1 -1 -1 -1 -1 -1 -1 -1 -1 -1 -1 -1 -1 -1 -1 -1 -1 -1 -1 -1 -1 -1 -1 -1 -1 -1 -1 -1 -1 -1 
-1 -1 -1 -1 -1 -1 -1 -1 -1 -1 -1 -1 -1 -1 -1 -1 -1 -1 -1 -1 -1 -1 -1 -1 -1 -1 -1 -1 -1 -1 -1 -1 -1 -1 -1 -1 
-1 -1 -1 -1 -1 -1 -1 -1 -1 -1 -1 -1 -1 -1 -1 -1 -1 -1 -1 -1 -1 -1 -1 -1 -1 -1 -1 -1 -1 -1 -1 -1 -1 -1 -1 -1 
-1 -1 -1 -1 -1 -1 -1 -1 -1 -1 -1 -1 -1 -1 -1 -1 -1 -1 -1 -1 -1 -1 -1 -1 -1 -1 -1 -1 -1 -1 -1 -1 -1 -1 -1 -1 
-1 -1 -1 -1 -1 -1 -1 -1 -1 -1 -1 -1 -1 -1 -1 -1 -1 -1 -1 -1 -1 -1 -1 -1 -1 -1 -1 -1 -1 -1 -1 -1 -1 -1 -1 -1 
-1 -1 -1 -1 -1 -1 -1 -1 -1 -1 -1 -1 -1 -1 -1 -1 -1 -1 -1 -1 -1 -1 -1 -1 -1 -1 -1 -1 -1 -1 -1 -1 -1 -1 -1 -1 
-1 -1 -1 -1 -1 -1 -1 -1 -1 -1 -1 -1 -1 -1 -1 -1 -1 -1 -1 -1 -1 -1 -1 -1 -1 -1 -1 -1 -1 -1 -1 -1 -1 -1 -1 -1 
