tile
col 64
row 64
3 3 3 2 2 2 6 6 6 6 6 6 6 6 6 6 6 6 6 6 6 6 6 6 6 6 6 6 6 6 6 6 6 6 6 3 3 6 6 6 6 6 6 6 6 6 3 3 6 6 6 3 3 6 6 6 6 6 6 6 6 6 6 6 
3 3 3 2 2 2 6 6 6 6 6 6 6 6 6 6 6 6 6 6 6 6 6 6 6 6 6 6 6 6 6 6 6 6 6 3 3 6 3 6 6 6 6 3 6 6 6 3 2 6 6 6 3 3 6 6 6 3 3 6 6 6 6 6 
3 3 3 2 2 2 6 6 6 6 6 6 6 6 6 6 6 6 6 6 6 6 6 6 6 6 6 6 6 6 6 6 6 6 6 3 3 6 6 3 6 6 6 6 3 6 6 6 3 3 6 6 6 3 3 6 6 6 3 3 6 6 6 6 
3 3 3 2 2 2 6 6 6 6 6 6 6 6 6 6 6 6 6 6 6 6 6 6 6 6 6 6 6 6 6 6 6 6 6 3 3 6 6 3 3 6 6 6 3 3 6 6 3 3 3 6 6 6 3 3 6 6 3 3 3 6 6 6 
3 3 3 2 2 2 6 6 6 6 6 6 6 6 6 6 6 6 6 6 6 6 6 6 6 6 6 6 6 6 6 6 6 6 6 3 3 6 6 3 3 6 6 6 3 3 6 6 6 3 3 6 6 6 3 3 6 6 6 3 3 6 6 6 
3 3 2 2 2 2 6 6 6 6 6 6 6 6 6 6 6 6 6 6 6 6 6 6 6 6 6 6 6 6 6 6 6 6 6 3 3 6 6 6 3 6 6 6 6 3 6 6 6 6 3 6 6 6 6 3 6 6 6 6 3 6 6 6 
3 2 3 2 2 2 6 6 6 6 6 6 6 6 6 6 6 6 6 6 6 6 6 6 6 6 6 6 6 6 6 6 6 6 6 3 3 6 6 6 3 6 6 6 6 3 6 6 6 6 3 6 6 6 6 3 6 6 6 6 3 6 6 6 
3 2 2 3 2 2 6 3 3 3 3 3 3 3 3 3 3 3 3 3 3 3 3 3 3 3 3 3 3 3 3 3 3 3 3 3 3 3 3 3 3 3 3 3 3 3 3 3 3 3 3 3 3 3 3 3 3 3 3 3 3 3 3 3 
2 2 2 2 2 2 6 3 6 6 6 6 6 6 6 6 6 6 6 6 6 6 6 6 6 6 6 6 6 6 6 6 6 6 6 3 3 6 6 6 6 6 6 6 6 6 6 6 6 6 6 6 6 6 6 6 3 6 6 6 6 6 6 6 
2 2 2 2 2 2 2 3 6 6 6 6 6 6 6 6 6 6 6 6 6 6 6 6 6 6 6 6 6 6 6 6 6 6 6 3 3 6 6 6 6 6 6 6 6 6 6 6 6 6 6 6 6 6 6 6 3 6 2 2 2 2 2 2 
6 6 6 6 6 6 6 3 6 6 3 3 3 3 3 3 3 3 3 3 3 3 3 3 3 3 3 3 3 3 3 3 3 3 3 3 3 3 3 3 3 3 3 3 3 3 3 3 3 3 3 3 3 3 6 6 3 6 2 2 2 2 2 2 
6 6 6 6 6 6 6 3 6 6 3 -1 -1 -1 -1 -1 -1 -1 -1 -1 -1 -1 -1 -1 -1 -1 -1 -1 -1 -1 -1 -1 -1 -1 -1 -1 -1 -1 -1 -1 -1 -1 -1 -1 -1 -1 -1 -1 -1 -1 -1 -1 -1 3 6 6 3 6 2 2 2 2 2 2 
3 3 3 3 3 3 3 3 6 6 3 9 -1 8 -1 8 -1 8 -1 8 -1 8 -1 8 -1 8 -1 8 -1 8 -1 8 -1 8 -1 25 25 8 -1 8 -1 8 -1 8 -1 8 -1 8 -1 8 -1 12 -1 3 6 6 3 6 2 2 2 2 2 2 
3 3 3 6 6 6 6 3 6 6 3 -1 -1 -1 -1 -1 -1 -1 -1 -1 -1 -1 -1 -1 -1 -1 -1 -1 -1 -1 -1 -1 -1 -1 -1 -1 -1 -1 -1 -1 -1 -1 -1 -1 -1 -1 -1 -1 -1 -1 -1 -1 -1 3 6 6 3 6 2 2 2 2 2 2 
3 3 3 6 6 6 6 3 6 6 3 7 -1 9 -1 8 -1 8 -1 8 -1 8 -1 13 -1 8 -1 8 -1 8 -1 8 -1 8 -1 25 25 8 -1 13 -1 8 -1 8 -1 8 -1 8 -1 12 -1 7 -1 3 6 6 3 6 2 2 2 2 2 2 
3 3 3 3 6 6 6 3 6 6 3 -1 -1 -1 -1 3 3 3 3 3 3 3 3 -1 -1 3 3 3 3 3 3 3 3 3 3 3 3 3 3 -1 -1 3 3 3 3 3 3 3 3 -1 -1 -1 -1 3 6 6 3 6 2 2 2 2 2 2 
3 3 3 6 6 6 6 3 6 6 3 7 -1 7 -1 3 6 6 6 6 6 6 3 7 -1 3 3 3 3 3 3 3 3 3 3 3 3 3 3 7 -1 3 6 6 6 6 6 6 3 7 -1 7 -1 3 6 6 3 6 2 2 2 2 2 2 
3 3 3 6 6 6 6 3 6 6 3 -1 -1 -1 -1 3 6 6 6 6 6 6 3 -1 -1 3 3 3 3 3 3 3 3 3 3 3 3 3 3 -1 -1 3 6 6 6 6 2 6 3 -1 -1 -1 -1 3 6 6 3 6 2 2 2 2 2 2 
3 3 3 3 6 6 6 3 6 6 3 7 -1 7 -1 3 6 6 6 6 6 6 3 7 -1 3 3 3 3 3 3 3 3 3 3 3 3 3 3 7 -1 3 6 2 2 2 2 6 3 7 -1 7 -1 3 6 6 3 6 2 2 2 2 2 2 
6 6 3 6 6 6 6 3 6 6 3 -1 -1 -1 -1 3 6 6 6 6 6 6 3 -1 -1 3 2 2 2 2 2 2 2 2 2 2 2 2 3 -1 -1 3 6 2 2 2 2 6 3 -1 -1 -1 -1 3 6 6 3 6 2 2 2 2 2 2 
6 6 3 6 6 6 6 3 6 6 3 7 -1 7 -1 3 6 6 6 6 6 6 3 7 -1 3 2 2 2 2 2 2 2 2 2 2 2 2 3 7 -1 3 6 6 2 2 6 6 3 7 -1 7 -1 3 6 6 3 6 2 2 2 2 2 2 
3 3 3 3 3 6 6 3 6 6 3 -1 -1 -1 -1 3 6 6 6 6 6 6 3 -1 -1 3 2 2 2 2 2 2 2 2 2 2 2 2 3 -1 -1 3 2 2 2 2 2 2 3 -1 -1 -1 -1 3 6 6 3 6 2 2 2 2 2 2 
3 3 3 3 3 6 6 3 6 6 3 7 -1 7 -1 3 3 3 3 3 3 3 3 7 -1 3 2 2 2 2 2 2 2 2 2 2 2 2 3 7 -1 3 3 3 3 3 3 3 3 7 -1 7 -1 3 6 6 3 6 2 2 2 2 2 2 
6 6 6 6 6 6 6 3 6 6 3 -1 -1 -1 -1 3 3 3 3 3 3 3 3 -1 -1 3 2 2 2 2 2 2 2 2 2 2 2 2 3 -1 -1 -1 -1 -1 -1 -1 -1 -1 -1 -1 -1 -1 -1 3 6 6 3 6 2 2 2 2 2 2 
6 6 6 6 6 6 6 3 6 6 3 7 -1 7 -1 3 3 3 3 3 3 3 3 7 -1 3 2 2 2 2 2 2 2 2 2 2 2 2 3 16 -1 8 -1 8 -1 8 -1 25 25 15 -1 7 -1 3 6 6 3 6 2 2 2 2 2 2 
6 6 6 6 6 6 6 3 6 6 3 -1 -1 -1 -1 3 3 3 3 3 3 3 3 -1 -1 3 3 3 3 3 3 3 3 3 3 3 3 3 3 -1 -1 3 3 3 3 3 3 3 3 -1 -1 -1 -1 3 6 6 3 6 2 2 2 2 2 2 
3 3 6 3 3 6 6 3 6 6 3 7 -1 7 -1 3 6 6 6 6 6 6 3 7 -1 3 6 6 6 6 6 6 6 6 6 6 6 6 3 7 -1 3 6 6 6 6 6 6 3 7 -1 7 -1 3 6 6 3 6 6 6 6 6 6 6 
3 3 3 3 3 3 3 3 3 3 3 24 -1 24 -1 3 6 6 6 6 6 6 3 24 -1 3 6 2 2 2 2 2 2 2 2 2 2 6 3 24 -1 3 6 6 6 6 6 6 3 24 -1 24 -1 3 3 3 3 3 3 3 3 3 3 3 
3 3 3 3 3 3 3 3 3 3 3 24 -1 24 -1 3 6 6 6 6 6 6 3 24 -1 3 6 2 2 2 2 2 2 2 2 2 2 6 3 24 -1 3 6 6 6 6 6 6 3 24 -1 24 -1 3 3 3 3 3 3 3 3 3 3 3 
3 3 3 3 3 3 6 3 6 6 3 -1 -1 -1 -1 3 6 6 6 6 6 6 3 -1 -1 3 6 2 2 2 2 2 2 2 2 2 2 6 3 -1 -1 3 6 6 6 6 6 6 3 -1 -1 -1 -1 3 6 6 3 6 6 6 6 6 6 6 
3 3 3 3 3 3 3 3 6 6 3 7 -1 7 -1 3 3 3 3 3 3 3 3 7 -1 3 6 2 2 2 2 2 2 2 2 2 2 6 3 7 -1 3 6 6 6 6 6 6 3 7 -1 7 -1 3 6 6 3 6 2 4 4 4 4 4 
3 3 3 3 3 3 3 3 6 6 3 -1 -1 -1 -1 -1 -1 -1 -1 -1 -1 -1 -1 -1 -1 3 6 2 2 2 2 2 2 2 2 2 2 6 3 -1 -1 3 6 6 6 6 6 6 3 -1 -1 -1 -1 3 6 6 3 6 2 2 2 2 2 2 
3 3 3 3 3 3 3 3 6 6 3 7 -1 16 -1 25 25 8 -1 8 -1 8 -1 11 -1 3 6 2 2 2 2 2 2 2 2 2 2 6 3 7 -1 3 6 6 6 6 6 6 3 7 -1 7 -1 3 6 6 3 6 2 2 2 2 2 2 
6 6 6 6 6 6 6 3 6 6 3 -1 -1 -1 -1 3 3 3 3 3 3 3 3 3 3 3 6 2 2 2 2 2 2 2 2 2 2 6 3 -1 -1 3 6 6 6 6 6 6 3 -1 -1 -1 -1 3 6 6 3 6 4 4 4 4 4 4 
6 6 6 6 6 6 6 3 6 6 3 7 -1 7 -1 3 6 6 6 6 6 6 6 6 6 6 6 2 2 2 2 2 2 2 2 2 2 6 3 7 -1 3 6 6 6 6 6 6 3 7 -1 7 -1 3 6 6 3 6 4 2 4 2 2 2 
6 6 6 6 6 6 6 3 6 6 3 -1 -1 -1 -1 3 6 6 6 6 6 6 6 6 6 6 6 2 2 2 2 2 2 2 2 2 2 6 3 -1 -1 3 6 6 6 6 6 6 3 -1 -1 -1 -1 3 6 6 3 6 4 2 2 2 2 2 
6 6 6 6 6 6 6 3 6 6 3 7 -1 7 -1 3 6 6 6 6 6 6 6 6 6 6 6 2 2 2 2 2 2 2 2 2 2 6 3 7 -1 3 6 6 6 6 6 6 3 7 -1 7 -1 3 6 6 3 6 4 4 4 4 4 4 
6 6 6 6 6 6 6 3 6 6 3 -1 -1 -1 -1 3 6 6 6 6 6 6 6 6 6 6 6 6 6 6 6 6 6 6 6 6 6 6 3 -1 -1 3 6 6 6 6 6 6 3 -1 -1 -1 -1 3 6 6 3 6 4 4 4 4 4 4 
6 6 6 6 6 6 6 3 6 6 3 7 -1 7 -1 3 3 3 3 3 3 3 3 3 3 3 3 3 3 3 3 3 3 3 3 3 3 3 3 7 -1 3 3 3 3 3 3 3 3 7 -1 7 -1 3 6 6 3 6 4 2 2 2 2 2 
6 6 6 6 6 6 6 3 6 6 3 -1 -1 -1 -1 -1 -1 -1 -1 -1 -1 -1 -1 -1 -1 3 3 3 3 3 3 3 3 3 3 3 3 3 3 -1 -1 3 3 3 3 3 3 3 3 -1 -1 -1 -1 3 6 6 3 6 4 2 2 2 2 2 
6 6 6 6 6 6 6 3 6 6 3 7 -1 10 -1 8 -1 8 -1 8 -1 8 -1 12 -1 3 3 3 3 3 3 3 3 3 3 3 3 3 3 7 -1 3 3 3 3 3 3 3 3 7 -1 7 -1 3 6 6 3 6 4 2 2 2 2 2 
6 6 6 6 3 3 3 3 6 6 3 -1 -1 -1 -1 -1 -1 -1 -1 -1 -1 -1 -1 -1 -1 3 3 3 3 3 3 3 3 3 3 3 3 3 3 -1 -1 3 3 3 3 3 3 3 3 -1 -1 -1 -1 3 6 6 3 6 2 4 4 4 4 4 
6 6 6 6 3 3 3 3 6 6 3 10 -1 8 -1 8 -1 8 -1 8 -1 12 -1 7 -1 3 3 3 3 3 3 3 3 3 3 3 3 3 3 7 -1 3 6 6 6 6 6 6 3 7 -1 7 -1 3 6 6 3 6 2 2 2 2 2 2 
6 6 6 6 6 6 6 3 6 6 3 3 3 3 3 3 3 3 3 3 3 -1 -1 -1 -1 3 3 3 3 3 3 3 3 3 3 3 3 3 3 7 -1 3 6 6 6 6 6 6 3 -1 -1 -1 -1 3 6 6 3 6 4 2 2 2 2 2 
6 6 6 6 6 6 6 3 6 6 3 6 6 6 6 6 6 6 6 6 3 7 -1 7 -1 3 3 3 3 3 3 6 6 6 6 6 6 6 3 7 -1 3 6 6 6 6 6 6 3 7 -1 7 -1 3 6 6 3 6 4 2 2 4 4 4 
6 6 6 6 6 6 6 3 6 6 3 6 6 6 6 6 6 6 6 6 3 -1 -1 -1 -1 3 3 3 3 3 3 6 2 2 2 2 2 6 3 -1 -1 3 6 6 6 6 6 6 3 -1 -1 -1 -1 3 6 6 3 6 4 4 4 4 4 4 
6 6 6 6 6 6 6 3 6 6 3 6 6 6 6 6 6 6 6 6 3 7 -1 7 -1 3 3 3 3 3 3 6 2 2 2 2 2 6 3 7 -1 3 6 6 6 6 6 6 3 7 -1 7 -1 3 6 6 3 6 6 6 6 6 6 6 
6 6 6 3 3 3 3 3 6 6 3 6 6 6 6 6 6 6 6 6 3 -1 -1 -1 -1 3 3 3 3 3 3 6 2 2 2 2 2 6 3 -1 -1 3 6 6 6 6 6 6 3 -1 -1 -1 -1 3 6 6 3 6 6 6 6 6 6 6 
6 6 6 6 6 6 6 3 6 6 3 6 6 6 6 6 6 6 6 6 3 7 -1 7 -1 3 3 3 3 3 3 2 2 2 2 2 2 2 3 7 -1 3 3 3 3 3 3 3 3 7 -1 7 -1 3 6 6 3 6 2 2 5 5 5 3 
6 6 6 6 6 6 6 3 6 6 3 6 6 6 6 6 6 6 6 6 3 -1 -1 -1 -1 -1 -1 -1 -1 -1 -1 -1 -1 -1 -1 -1 -1 -1 -1 -1 -1 -1 -1 -1 -1 -1 -1 -1 -1 -1 -1 -1 -1 3 6 6 3 6 2 2 5 5 5 3 
6 6 6 3 3 3 3 3 6 6 3 6 6 6 6 6 6 6 6 6 3 7 -1 10 -1 8 -1 25 25 8 -1 8 -1 8 -1 8 -1 8 -1 14 -1 8 -1 8 -1 8 -1 8 -1 11 -1 7 -1 3 6 6 3 6 2 2 2 5 5 3 
6 6 6 6 6 6 6 3 6 6 3 6 6 6 6 6 6 6 6 6 3 -1 -1 -1 -1 -1 -1 -1 -1 -1 -1 -1 -1 -1 -1 -1 -1 -1 -1 -1 -1 -1 -1 -1 -1 -1 -1 -1 -1 -1 -1 -1 -1 3 6 6 3 6 2 2 2 5 5 3 
6 6 6 6 6 6 6 3 6 6 3 6 6 6 6 6 6 6 6 6 3 10 -1 8 -1 8 -1 25 25 8 -1 8 -1 8 -1 8 -1 8 -1 8 -1 8 -1 8 -1 8 -1 8 -1 8 -1 11 -1 3 6 6 3 6 2 2 2 5 5 3 
6 6 6 3 3 3 3 3 6 6 3 3 3 3 3 3 3 3 3 3 3 3 3 3 3 3 3 3 3 3 3 3 3 3 3 3 3 3 3 3 3 3 3 3 3 3 3 3 3 3 3 3 3 3 6 6 3 6 2 2 5 5 5 3 
6 6 6 6 6 6 6 3 6 6 6 6 6 6 6 6 6 6 6 6 6 6 6 6 6 6 6 3 3 6 6 6 6 6 6 6 6 6 6 6 6 6 6 6 6 6 6 6 6 6 6 6 6 6 6 6 3 6 5 5 2 5 5 3 
6 6 6 3 6 6 6 3 6 6 6 6 6 6 6 6 6 6 6 6 6 6 6 6 6 6 6 3 3 6 6 6 6 6 6 6 6 6 6 6 6 6 6 6 6 6 6 6 6 6 6 6 6 6 6 6 3 6 5 5 5 5 5 3 
6 6 6 6 6 6 6 3 3 3 3 3 3 3 3 3 3 3 3 3 3 3 3 3 3 3 3 3 3 3 3 3 3 3 3 3 3 3 3 3 3 3 3 3 3 3 3 3 3 3 3 3 3 3 3 3 3 6 5 5 5 5 5 3 
6 6 6 6 6 6 6 6 6 6 6 6 6 6 6 6 6 6 6 6 6 6 6 6 6 6 6 3 3 6 6 6 6 6 6 6 6 6 6 6 6 6 6 6 6 6 6 6 6 6 6 6 6 6 6 6 6 6 6 6 6 6 6 6 
2 -1 2 -1 2 -1 2 -1 -1 -1 -1 -1 -1 -1 -1 -1 -1 -1 -1 -1 -1 -1 -1 -1 -1 -1 6 3 3 6 2 2 2 2 2 2 2 2 2 2 2 2 2 2 2 2 2 2 2 2 2 2 2 2 2 2 2 2 2 2 2 2 2 2 
8 -1 8 -1 8 -1 8 -1 8 -1 8 -1 8 -1 8 -1 8 -1 13 -1 8 -1 8 -1 12 -1 6 3 3 6 2 2 2 2 2 2 2 2 2 2 2 2 2 2 2 2 2 2 2 2 2 2 2 2 2 2 2 2 2 2 2 2 2 2 
2 2 2 2 2 2 2 2 2 2 2 2 2 2 2 2 2 2 -1 2 2 2 2 2 -1 -1 6 3 3 6 2 -1 -1 -1 -1 -1 -1 -1 -1 -1 -1 -1 -1 -1 -1 -1 -1 -1 -1 -1 -1 -1 -1 -1 -1 -1 -1 -1 -1 -1 -1 -1 -1 -1 
2 2 2 2 2 2 2 2 2 2 2 2 2 2 2 2 2 2 7 -1 2 2 2 2 7 -1 6 3 3 6 9 -1 8 -1 8 -1 8 -1 8 -1 8 -1 8 -1 8 -1 8 -1 8 -1 8 -1 8 -1 8 -1 8 -1 13 -1 8 -1 8 -1 
2 2 2 2 2 2 2 2 2 2 2 2 2 2 2 2 2 2 -1 -1 2 2 2 2 -1 -1 6 3 3 6 -1 -1 2 2 2 2 2 2 2 6 6 6 6 6 6 6 6 6 6 6 6 6 6 3 2 2 2 2 -1 -1 2 2 2 2 
-1 2 2 2 2 2 2 2 2 2 2 2 2 2 2 2 2 2 7 -1 2 2 2 2 7 -1 6 3 3 6 7 -1 2 2 2 2 2 2 2 6 6 6 6 6 6 6 6 6 6 6 6 6 6 3 2 2 2 2 7 -1 2 2 2 2 
