object
col 64
row 64
-1 -1 -1 -1 -1 -1 -1 -1 34 41 35 41 35 41 -1 41 35 41 35 41 35 41 -1 41 -1 35 41 35 41 35 41 35 41 41 34 -1 -1 -1 -1 39 39 39 -1 -1 39 39 39 -1 -1 39 39 39 -1 -1 39 39 39 39 -1 39 39 39 39 39 
-1 -1 -1 -1 -1 -1 62 -1 34 41 40 -1 -1 35 41 40 -1 -1 41 35 42 35 -1 40 -1 42 -1 43 35 43 35 40 35 41 34 -1 -1 34 -1 -1 39 39 -1 -1 -1 39 39 39 -1 -1 39 39 -1 -1 -1 39 39 -1 -1 -1 39 39 39 39 
60 -1 -1 60 -1 -1 -1 -1 34 43 35 35 43 41 -1 -1 35 41 42 -1 35 43 35 42 35 41 -1 -1 35 35 -1 35 -1 34 34 -1 -1 34 -1 -1 -1 -1 -1 -1 -1 -1 -1 -1 -1 -1 -1 -1 -1 -1 -1 -1 -1 -1 -1 -1 -1 -1 -1 39 
-1 -1 -1 -1 -1 101 -1 -1 34 35 43 -1 35 -1 35 43 41 -1 35 35 40 -1 42 -1 35 -1 35 43 41 -1 35 42 -1 42 34 -1 -1 34 -1 -1 -1 -1 -1 -1 -1 -1 -1 -1 -1 -1 -1 -1 -1 39 -1 -1 -1 -1 39 -1 -1 -1 -1 39 
-1 -1 -1 -1 -1 -1 -1 -1 34 42 35 -1 40 -1 43 -1 -1 -1 40 -1 -1 -1 43 35 42 41 40 -1 35 -1 42 35 35 41 34 -1 -1 34 39 -1 -1 -1 -1 39 -1 -1 -1 -1 39 -1 -1 -1 -1 39 -1 -1 -1 -1 39 -1 -1 -1 -1 39 
59 -1 -1 59 -1 -1 86 86 34 35 35 41 40 35 41 35 42 35 43 35 41 42 35 41 35 35 42 35 43 35 43 35 40 35 34 -1 -1 34 39 -1 46 -1 -1 39 -1 46 -1 -1 39 -1 46 -1 -1 39 -1 46 -1 -1 39 -1 46 -1 -1 39 
-1 -1 -1 -1 -1 101 35 35 106 35 36 36 35 106 35 36 36 33 106 35 36 36 35 106 35 35 35 35 106 35 35 35 35 35 106 -1 -1 106 35 106 -1 106 101 35 106 -1 106 35 35 106 -1 106 35 101 106 -1 106 35 35 106 -1 106 35 35 
-1 -1 -1 -1 -1 -1 92 -1 -1 -1 -1 -1 -1 -1 -1 -1 -1 -1 -1 -1 -1 -1 -1 -1 -1 -1 -1 -1 -1 -1 -1 -1 -1 -1 -1 -1 -1 -1 -1 -1 -1 -1 -1 -1 -1 -1 -1 -1 -1 -1 -1 -1 -1 -1 -1 -1 -1 -1 -1 -1 -1 -1 -1 -1 
59 -1 -1 60 -1 -1 105 -1 106 -1 42 -1 -1 106 -1 42 -1 -1 106 -1 42 -1 -1 106 -1 42 -1 -1 106 -1 42 -1 -1 -1 106 95 95 42 -1 -1 -1 106 42 -1 -1 -1 106 42 -1 106 -1 -1 42 -1 -1 101 -1 -1 97 97 97 97 97 97 
-1 -1 102 -1 -1 -1 -1 -1 -1 45 35 97 97 35 44 35 97 97 35 44 35 97 97 35 44 35 97 97 35 44 35 97 97 35 44 98 98 97 35 44 35 97 97 35 44 35 97 97 35 44 35 97 97 35 45 -1 -1 34 32 -1 -1 -1 -1 -1 
97 97 97 26 97 97 89 -1 -1 34 -1 -1 -1 -1 -1 -1 -1 -1 -1 -1 -1 -1 -1 101 -1 -1 -1 -1 -1 -1 -1 -1 -1 -1 -1 -1 -1 -1 -1 -1 -1 -1 -1 -1 -1 -1 -1 -1 -1 -1 -1 -1 -1 -1 34 41 -1 34 -1 -1 -1 -1 -1 -1 
97 97 97 26 97 97 87 -1 41 98 -1 -1 -1 -1 -1 -1 -1 -1 -1 -1 -1 -1 -1 -1 -1 -1 -1 -1 -1 -1 -1 -1 -1 -1 -1 -1 -1 -1 -1 -1 -1 -1 -1 -1 -1 -1 -1 -1 -1 -1 -1 -1 -1 -1 98 106 -1 106 -1 -1 -1 -1 -1 -1 
-1 -1 -1 -1 -1 -1 -1 -1 34 98 -1 -1 -1 -1 -1 -1 -1 -1 -1 -1 -1 -1 -1 -1 -1 -1 -1 -1 -1 -1 -1 -1 -1 -1 -1 -1 -1 -1 -1 -1 -1 -1 -1 -1 -1 -1 -1 -1 -1 -1 -1 -1 -1 -1 98 -1 -1 -1 -1 -1 -1 -1 -1 -1 
-1 -1 -1 -1 -1 40 105 -1 106 34 -1 -1 -1 -1 -1 -1 -1 -1 -1 -1 -1 -1 -1 -1 -1 -1 -1 -1 -1 -1 -1 -1 -1 -1 -1 -1 -1 -1 -1 -1 -1 -1 -1 -1 -1 -1 -1 -1 -1 -1 -1 -1 -1 -1 34 -1 -1 27 -1 -1 -1 -1 -1 -1 
59 -1 -1 59 -1 40 -1 -1 -1 44 -1 -1 -1 -1 -1 -1 -1 -1 -1 -1 -1 -1 -1 -1 -1 -1 -1 -1 -1 -1 -1 -1 -1 -1 -1 -1 -1 -1 -1 -1 -1 -1 -1 -1 -1 -1 -1 -1 -1 -1 -1 -1 -1 -1 44 -1 -1 27 -1 -1 -1 -1 -1 -1 
-1 -1 -1 -1 -1 40 -1 -1 34 34 -1 -1 -1 -1 -1 -1 -1 -1 -1 -1 -1 -1 -1 -1 -1 -1 -1 -1 -1 -1 -1 -1 -1 -1 -1 -1 -1 -1 -1 -1 -1 -1 -1 -1 -1 -1 -1 -1 -1 -1 -1 -1 -1 -1 34 41 -1 -1 -1 -1 -1 -1 -1 -1 
-1 -1 -1 -1 -1 40 -1 -1 41 98 -1 -1 -1 -1 -1 -1 -1 -1 35 35 -1 -1 -1 -1 -1 -1 -1 -1 -1 -1 -1 -1 -1 -1 -1 -1 -1 -1 -1 -1 -1 -1 -1 -1 -1 -1 -1 -1 -1 -1 -1 -1 -1 -1 98 106 -1 106 -1 -1 -1 -1 -1 -1 
60 -1 -1 60 -1 40 -1 -1 34 98 -1 -1 -1 -1 -1 -1 34 -1 -1 30 -1 34 -1 -1 -1 -1 -1 -1 -1 -1 -1 -1 -1 -1 -1 -1 -1 -1 -1 -1 -1 -1 -1 -1 -1 -1 33 -1 -1 -1 -1 -1 -1 -1 98 -1 -1 -1 -1 -1 -1 -1 -1 -1 
-1 -1 -1 -1 -1 40 -1 -1 -1 34 -1 -1 -1 -1 -1 -1 -1 -1 -1 -1 -1 -1 -1 -1 -1 -1 -1 -1 -1 -1 -1 -1 -1 -1 -1 -1 -1 -1 -1 -1 -1 -1 -1 -1 -1 -1 -1 -1 -1 -1 -1 -1 -1 -1 34 -1 -1 27 -1 -1 -1 -1 -1 -1 
-1 -1 -1 -1 -1 40 106 -1 106 44 -1 -1 -1 -1 -1 -1 -1 -1 -1 -1 -1 -1 -1 -1 -1 -1 -1 -1 -1 -1 -1 -1 -1 -1 -1 -1 -1 -1 -1 -1 -1 -1 -1 -1 -1 -1 -1 -1 -1 -1 -1 -1 -1 -1 44 -1 -1 27 -1 -1 -1 -1 -1 -1 
59 -1 -1 59 -1 40 -1 -1 34 34 -1 -1 -1 -1 -1 -1 34 -1 47 -1 34 -1 -1 -1 -1 -1 -1 -1 -1 -1 -1 -1 -1 -1 -1 -1 -1 -1 -1 -1 -1 -1 -1 34 70 -1 34 -1 -1 -1 -1 -1 -1 -1 34 41 -1 -1 -1 -1 -1 -1 -1 -1 
-1 -1 -1 -1 -1 40 -1 -1 41 98 -1 -1 -1 -1 -1 -1 -1 -1 35 -1 -1 -1 -1 -1 -1 -1 -1 -1 -1 50 -1 -1 -1 -1 -1 -1 -1 -1 -1 -1 -1 -1 -1 -1 -1 -1 -1 -1 -1 -1 -1 -1 -1 -1 98 106 -1 106 -1 -1 -1 -1 -1 -1 
-1 -1 -1 -1 -1 40 -1 -1 34 98 -1 -1 -1 -1 -1 -1 -1 -1 -1 -1 -1 -1 -1 -1 -1 -1 -1 -1 -1 50 -1 -1 -1 -1 -1 -1 -1 -1 -1 -1 -1 -1 -1 -1 -1 -1 -1 -1 -1 -1 -1 -1 -1 -1 98 -1 -1 -1 -1 -1 -1 -1 -1 -1 
40 40 40 40 40 40 -1 -1 -1 34 -1 -1 -1 -1 -1 -1 -1 -1 -1 -1 -1 -1 -1 -1 -1 -1 -1 -1 -1 50 -1 -1 -1 -1 55 -1 -1 -1 102 -1 -1 -1 -1 -1 -1 -1 -1 -1 -1 -1 -1 -1 -1 -1 34 -1 -1 34 -1 -1 -1 -1 -1 -1 
-1 -1 40 -1 -1 40 -1 -1 -1 44 -1 -1 -1 -1 -1 -1 -1 -1 -1 -1 -1 -1 -1 -1 -1 -1 -1 -1 -1 -1 -1 -1 -1 -1 -1 -1 -1 -1 -1 -1 -1 -1 -1 -1 -1 -1 -1 -1 -1 -1 -1 -1 -1 -1 44 -1 -1 34 -1 -1 -1 -1 -1 -1 
58 -1 40 113 -1 40 -1 -1 34 34 -1 -1 -1 -1 -1 -1 -1 -1 -1 -1 -1 -1 -1 -1 -1 -1 -1 -1 -1 -1 -1 -1 -1 -1 -1 -1 -1 -1 -1 -1 -1 -1 -1 -1 -1 -1 -1 -1 -1 -1 -1 -1 -1 -1 34 41 -1 -1 32 -1 -1 -1 -1 -1 
-1 -1 40 -1 -1 40 106 -1 41 98 -1 -1 -1 -1 -1 -1 35 35 35 35 35 35 -1 -1 -1 -1 -1 -1 -1 35 -1 -1 -1 35 35 -1 35 -1 -1 -1 -1 -1 -1 -1 -1 -1 -1 -1 -1 -1 -1 -1 -1 -1 98 -1 -1 106 97 97 97 97 97 97 
102 -1 -1 -1 102 -1 -1 -1 96 97 -1 -1 -1 -1 -1 -1 34 48 -1 48 -1 42 -1 -1 -1 -1 -1 -1 -1 -1 -1 -1 -1 -1 -1 -1 -1 -1 -1 -1 -1 -1 -1 -1 -1 -1 -1 -1 -1 -1 -1 -1 -1 -1 97 96 -1 -1 -1 -1 -1 -1 -1 -1 
-1 -1 -1 -1 -1 -1 -1 -1 96 97 -1 -1 -1 -1 -1 -1 34 48 -1 48 -1 42 -1 -1 -1 -1 34 61 -1 -1 -1 -1 -1 -1 -1 58 -1 -1 -1 -1 -1 -1 -1 -1 -1 -1 -1 -1 -1 -1 -1 -1 -1 -1 97 96 -1 -1 -1 -1 -1 -1 -1 -1 
-1 -1 -1 -1 -1 -1 106 -1 106 44 -1 -1 -1 -1 -1 -1 42 -1 -1 -1 -1 35 -1 -1 -1 -1 -1 -1 -1 -1 -1 -1 -1 -1 -1 -1 -1 34 -1 -1 -1 -1 -1 -1 -1 -1 -1 -1 -1 -1 -1 -1 -1 -1 44 -1 -1 106 97 97 97 97 97 97 
-1 -1 -1 -1 -1 -1 -1 -1 -1 34 -1 -1 -1 -1 -1 -1 -1 -1 -1 -1 -1 -1 -1 -1 -1 -1 -1 -1 -1 -1 -1 -1 -1 -1 -1 -1 -1 -1 -1 -1 -1 -1 -1 -1 57 -1 -1 -1 -1 -1 -1 -1 -1 -1 34 41 -1 44 -1 35 35 35 35 35 
60 -1 -1 109 -1 -1 -1 -1 34 98 -1 -1 -1 -1 -1 -1 -1 -1 -1 -1 -1 -1 -1 -1 -1 -1 -1 -1 -1 -1 -1 -1 -1 -1 -1 -1 -1 -1 -1 -1 -1 -1 -1 -1 -1 -1 -1 -1 -1 -1 -1 -1 -1 -1 98 -1 -1 44 34 -1 -1 -1 -1 -1 
-1 -1 -1 -1 -1 -1 -1 -1 41 98 -1 -1 -1 -1 -1 -1 -1 -1 -1 -1 -1 -1 -1 -1 -1 -1 -1 -1 -1 -1 -1 -1 -1 -1 -1 27 -1 -1 -1 -1 -1 -1 -1 -1 -1 -1 -1 -1 -1 -1 -1 -1 -1 -1 98 106 -1 45 34 108 -1 106 -1 106 
41 41 41 41 41 41 41 -1 34 34 -1 -1 -1 -1 -1 -1 -1 -1 -1 -1 -1 -1 -1 -1 -1 -1 -1 -1 -1 -1 -1 -1 38 -1 -1 27 -1 -1 -1 -1 -1 -1 -1 -1 -1 -1 -1 -1 -1 -1 -1 -1 -1 -1 34 -1 -1 44 -1 35 35 35 35 35 
41 35 35 41 35 42 37 -1 106 44 -1 -1 -1 -1 -1 -1 -1 39 97 26 97 39 -1 -1 -1 -1 -1 -1 -1 -1 -1 -1 -1 -1 -1 -1 -1 -1 -1 -1 -1 -1 -1 -1 -1 -1 -1 -1 -1 -1 -1 -1 -1 -1 44 -1 -1 45 34 -1 -1 106 -1 106 
35 34 35 35 35 35 37 -1 -1 34 -1 -1 -1 -1 -1 -1 -1 -1 -1 -1 -1 -1 -1 -1 -1 -1 -1 -1 -1 -1 -1 -1 26 26 -1 -1 -1 -1 -1 -1 -1 -1 -1 -1 -1 -1 -1 -1 -1 -1 -1 -1 -1 -1 34 41 -1 44 34 108 -1 -1 -1 -1 
35 35 35 42 35 39 41 -1 34 98 -1 -1 -1 -1 -1 -1 -1 -1 -1 -1 -1 -1 -1 -1 -1 -1 -1 58 -1 -1 -1 -1 -1 -1 -1 -1 -1 -1 -1 -1 -1 -1 -1 -1 -1 -1 -1 -1 -1 -1 -1 -1 -1 -1 98 -1 -1 44 34 35 35 35 35 35 
-1 -1 41 35 35 39 102 -1 41 98 -1 -1 -1 -1 -1 -1 -1 39 97 36 97 39 -1 -1 -1 -1 35 -1 -1 35 -1 -1 -1 -1 -1 -1 -1 -1 -1 -1 -1 -1 -1 -1 -1 -1 -1 -1 -1 -1 -1 -1 -1 -1 98 106 -1 44 34 -1 102 106 -1 101 
-1 40 -1 39 35 35 41 -1 -1 34 -1 -1 -1 -1 -1 -1 -1 -1 -1 -1 -1 -1 -1 -1 -1 -1 -1 -1 -1 -1 -1 -1 -1 -1 -1 -1 -1 -1 -1 -1 -1 -1 -1 -1 -1 -1 -1 -1 -1 -1 -1 -1 -1 -1 34 -1 -1 45 34 -1 -1 -1 -1 -1 
-1 41 -1 40 -1 39 37 -1 106 44 -1 -1 -1 -1 -1 -1 -1 -1 -1 -1 -1 -1 -1 -1 -1 -1 -1 -1 -1 -1 -1 -1 -1 -1 -1 -1 -1 -1 -1 -1 -1 -1 -1 -1 -1 -1 -1 -1 -1 -1 -1 -1 -1 -1 44 -1 -1 44 34 114 -1 -1 -1 -1 
-1 41 35 -1 39 41 41 -1 -1 34 -1 -1 -1 -1 -1 -1 -1 -1 -1 -1 -1 -1 -1 -1 -1 -1 -1 -1 -1 -1 -1 -1 -1 -1 -1 -1 -1 -1 -1 -1 -1 -1 -1 -1 -1 -1 -1 -1 -1 -1 -1 -1 -1 -1 34 41 -1 45 34 30 88 106 -1 -1 
-1 41 -1 -1 39 -1 -1 -1 34 98 -1 -1 -1 -1 -1 -1 -1 -1 -1 -1 -1 -1 -1 -1 -1 -1 -1 -1 -1 -1 -1 -1 -1 -1 -1 -1 -1 -1 -1 -1 -1 -1 -1 -1 -1 -1 -1 -1 -1 -1 -1 -1 -1 -1 98 -1 -1 44 -1 -1 35 35 35 35 
-1 41 -1 34 -1 -1 -1 -1 41 98 -1 -1 -1 -1 -1 -1 -1 -1 -1 -1 -1 -1 -1 -1 -1 -1 -1 -1 -1 -1 -1 -1 -1 -1 -1 -1 -1 -1 -1 -1 -1 -1 -1 -1 -1 -1 -1 -1 -1 -1 -1 -1 -1 -1 98 106 -1 44 -1 -1 -1 28 93 93 
41 41 -1 71 -1 -1 -1 -1 -1 34 -1 -1 -1 -1 -1 -1 -1 -1 -1 -1 -1 -1 -1 -1 -1 -1 -1 -1 -1 -1 -1 -1 -1 -1 -1 -1 -1 -1 -1 -1 -1 -1 -1 35 35 -1 35 35 -1 -1 -1 -1 -1 -1 34 -1 -1 45 34 -1 -1 -1 -1 -1 
41 41 42 42 40 40 42 -1 106 44 -1 93 91 -1 -1 -1 -1 -1 35 34 -1 -1 -1 -1 -1 -1 -1 -1 -1 -1 -1 40 35 40 35 40 35 40 -1 -1 -1 -1 -1 -1 -1 -1 -1 -1 -1 -1 -1 -1 -1 -1 44 -1 -1 44 34 73 -1 35 35 35 
41 34 -1 -1 35 35 -1 -1 -1 34 -1 94 -1 -1 -1 -1 -1 -1 -1 -1 -1 -1 -1 -1 -1 -1 -1 -1 -1 -1 -1 34 -1 -1 -1 -1 -1 34 -1 -1 -1 -1 -1 34 -1 -1 -1 34 -1 -1 -1 -1 -1 -1 34 41 -1 44 34 -1 -1 106 -1 106 
41 34 118 -1 86 86 -1 -1 -1 27 -1 -1 -1 106 97 35 97 106 -1 -1 -1 -1 -1 -1 -1 -1 -1 -1 -1 -1 -1 40 103 -1 -1 -1 28 40 -1 -1 -1 -1 -1 34 -1 46 32 34 -1 -1 -1 -1 -1 -1 98 -1 -1 44 45 45 45 45 45 45 
43 34 115 -1 -1 -1 -1 -1 41 27 -1 -1 -1 98 -1 -1 -1 98 -1 -1 -1 -1 -1 -1 -1 -1 -1 -1 -1 -1 -1 34 -1 -1 74 -1 -1 34 -1 -1 -1 -1 -1 -1 -1 -1 -1 -1 -1 -1 -1 -1 -1 -1 98 106 -1 45 45 45 45 45 45 45 
43 34 35 -1 35 35 104 -1 -1 34 -1 -1 -1 34 -1 -1 -1 34 -1 -1 -1 -1 -1 -1 -1 -1 -1 -1 -1 -1 -1 -1 -1 -1 -1 -1 -1 -1 -1 -1 -1 -1 -1 -1 -1 -1 -1 -1 -1 -1 -1 -1 -1 -1 34 -1 -1 45 -1 -1 -1 -1 -1 -1 
41 34 118 -1 -1 -1 37 -1 106 44 -1 -1 -1 98 -1 38 -1 98 -1 -1 -1 -1 -1 -1 -1 -1 -1 -1 -1 -1 -1 -1 -1 -1 -1 -1 -1 -1 -1 -1 -1 -1 -1 -1 -1 -1 -1 -1 -1 -1 -1 -1 -1 -1 44 -1 -1 44 -1 -1 -1 -1 -1 -1 
41 34 115 -1 -1 -1 -1 -1 -1 34 -1 -1 -1 106 97 35 97 106 -1 -1 -1 -1 -1 -1 -1 -1 -1 -1 -1 -1 -1 -1 -1 -1 -1 -1 -1 -1 -1 -1 -1 -1 -1 -1 -1 -1 -1 -1 -1 -1 -1 -1 -1 -1 34 41 -1 44 -1 -1 -1 -1 -1 -1 
41 34 92 -1 -1 -1 104 -1 -1 98 -1 34 -1 -1 -1 -1 -1 -1 -1 94 -1 -1 -1 -1 -1 -1 -1 -1 -1 -1 -1 -1 -1 -1 -1 -1 -1 -1 -1 -1 -1 -1 -1 -1 -1 -1 -1 -1 -1 -1 -1 -1 -1 -1 98 -1 -1 45 -1 -1 -1 -1 -1 -1 
41 34 -1 89 35 35 37 -1 41 98 -1 35 -1 -1 -1 -1 -1 -1 93 91 -1 -1 -1 -1 -1 -1 -1 -1 -1 -1 -1 -1 -1 -1 -1 -1 -1 -1 -1 -1 -1 -1 -1 -1 -1 -1 -1 -1 -1 -1 -1 -1 -1 -1 98 106 -1 44 -1 -1 -1 -1 -1 -1 
41 34 118 -1 -1 -1 -1 -1 -1 34 -1 -1 -1 -1 -1 -1 -1 -1 -1 -1 -1 -1 -1 -1 -1 -1 -1 -1 -1 -1 -1 -1 -1 -1 -1 -1 -1 -1 -1 -1 -1 -1 -1 -1 -1 -1 -1 -1 -1 -1 -1 -1 -1 -1 34 -1 -1 45 -1 -1 -1 -1 -1 -1 
41 34 -1 -1 -1 -1 -1 -1 -1 45 35 97 97 35 44 35 26 26 35 44 35 97 97 35 44 35 97 98 98 44 35 97 97 35 44 35 97 97 35 44 35 97 97 35 44 35 97 97 35 44 35 97 97 35 45 -1 -1 44 -1 -1 -1 -1 -1 -1 
41 34 118 -1 -1 -1 -1 -1 -1 -1 40 106 -1 -1 -1 40 106 -1 -1 -1 40 106 -1 -1 -1 40 106 95 95 -1 40 -1 106 -1 -1 40 -1 106 -1 -1 40 -1 106 -1 -1 40 -1 106 -1 -1 40 -1 106 -1 -1 39 -1 44 -1 -1 -1 -1 -1 -1 
41 34 -1 -1 -1 -1 -1 -1 -1 -1 -1 -1 -1 -1 -1 -1 -1 -1 -1 -1 -1 -1 -1 -1 -1 -1 -1 -1 -1 -1 -1 -1 -1 -1 -1 -1 -1 -1 -1 -1 -1 -1 -1 -1 -1 -1 -1 -1 -1 -1 -1 -1 -1 -1 -1 -1 -1 45 -1 -1 65 -1 -1 -1 
41 45 45 105 44 44 41 41 -1 -1 -1 44 -1 -1 45 44 44 45 45 44 44 44 45 44 44 44 106 -1 -1 106 45 44 45 44 45 45 44 44 45 44 44 45 45 44 45 44 45 44 44 44 45 44 45 44 44 45 44 45 45 44 44 45 44 45 
-1 -1 -1 -1 -1 -1 -1 -1 -1 -1 -1 -1 -1 -1 -1 -1 -1 -1 -1 -1 -1 -1 -1 -1 -1 -1 44 -1 -1 45 -1 -1 88 -1 -1 -1 -1 -1 -1 -1 -1 -1 -1 -1 -1 -1 -1 -1 -1 -1 -1 -1 -1 -1 -1 -1 -1 -1 -1 -1 -1 -1 -1 -1 
-1 -1 -1 -1 -1 -1 -1 -1 -1 -1 -1 -1 -1 -1 -1 -1 -1 -1 -1 -1 -1 -1 -1 -1 -1 -1 45 -1 -1 45 114 -1 -1 -1 35 103 35 36 35 103 35 35 35 103 35 36 35 103 35 35 35 103 35 36 35 103 -1 -1 -1 103 -1 -1 -1 103 
40 40 40 40 40 40 40 40 40 40 40 40 40 40 40 40 40 40 -1 -1 -1 -1 -1 -1 -1 -1 45 -1 -1 44 -1 -1 -1 -1 -1 -1 -1 -1 -1 -1 -1 -1 -1 -1 -1 -1 -1 -1 -1 -1 -1 -1 -1 -1 -1 -1 -1 -1 -1 -1 -1 -1 -1 -1 
-1 -1 -1 -1 -1 -1 -1 -1 -1 -1 -1 -1 -1 -1 -1 -1 -1 40 -1 -1 -1 -1 -1 -1 -1 -1 44 -1 -1 45 -1 -1 25 25 -1 -1 -1 -1 -1 -1 -1 -1 -1 -1 -1 -1 -1 -1 -1 -1 -1 -1 -1 -1 -1 -1 25 25 -1 -1 25 25 -1 -1 
58 -1 -1 58 -1 -1 58 -1 -1 58 -1 -1 58 -1 -1 58 -1 40 -1 -1 -1 -1 -1 -1 -1 -1 45 -1 -1 44 -1 -1 -1 -1 -1 -1 -1 -1 -1 34 35 35 35 35 35 35 35 35 35 35 35 35 34 -1 -1 -1 -1 102 95 95 102 -1 -1 -1 
-1 -1 -1 -1 -1 -1 -1 -1 -1 -1 -1 -1 -1 -1 -1 -1 -1 -1 24 -1 -1 57 -1 -1 -1 -1 44 -1 -1 45 -1 -1 -1 87 -1 87 -1 87 -1 34 106 -1 -1 -1 -1 106 -1 -1 -1 -1 -1 106 34 -1 -1 -1 -1 -1 24 -1 -1 -1 -1 -1 
