tile
col 56
row 56
4 4 4 4 4 4 4 4 4 4 4 4 4 4 4 4 4 4 4 4 4 4 4 4 4 4 4 4 4 4 4 4 4 4 4 4 4 4 4 4 4 4 4 4 4 4 4 4 4 4 4 4 4 4 4 4 
4 4 4 4 4 4 4 4 4 4 4 4 4 4 4 4 4 4 4 4 4 4 4 4 4 4 4 4 4 4 4 4 4 4 4 4 4 4 4 4 4 4 4 4 4 4 4 4 4 4 4 4 4 4 4 4 
4 4 3 3 3 3 3 3 3 3 3 3 3 3 3 3 3 3 3 3 3 3 3 3 3 3 3 3 3 3 3 3 3 3 3 3 3 3 3 3 3 3 3 3 3 3 3 3 3 3 3 3 3 3 4 4 
4 4 3 6 6 6 6 6 6 6 6 6 6 6 6 6 6 6 6 6 6 6 6 6 6 6 6 6 6 6 6 6 6 2 2 6 6 5 5 6 6 6 6 6 6 6 6 6 6 6 6 6 6 3 4 4 
4 4 3 6 6 6 6 6 6 6 6 6 5 6 6 5 6 6 5 6 6 5 6 6 5 2 6 6 5 5 2 2 5 2 2 5 6 2 5 6 6 6 6 6 6 6 6 6 6 6 6 6 6 3 4 4 
4 4 3 6 6 2 2 2 2 5 5 5 5 2 2 5 2 2 5 2 2 5 2 2 5 2 2 5 5 5 2 2 5 2 2 5 2 2 5 6 6 6 6 2 2 2 2 2 2 2 2 2 2 3 4 4 
4 4 3 6 6 2 2 2 2 5 5 5 5 2 2 5 2 2 5 2 2 5 2 2 5 2 2 5 5 5 2 2 5 2 2 5 2 2 5 6 6 6 6 2 2 2 2 2 2 2 2 2 2 3 4 4 
4 4 3 3 3 2 2 2 2 5 5 5 5 2 2 5 2 2 5 2 2 5 2 2 5 2 2 2 2 2 2 2 5 2 2 5 2 2 5 6 6 6 6 2 2 2 2 2 2 2 2 2 2 3 4 4 
4 4 4 4 4 2 2 2 2 2 2 2 2 2 2 2 2 2 2 2 2 2 2 2 2 2 2 2 2 2 2 2 2 2 2 2 2 2 2 2 2 2 2 2 2 2 2 2 2 2 2 2 2 3 4 4 
4 4 4 4 4 2 2 2 2 2 2 2 2 2 2 2 2 2 2 2 2 2 2 2 2 2 2 2 2 2 2 2 2 2 2 2 2 2 2 2 2 2 2 2 2 2 2 2 2 2 2 2 2 3 4 4 
4 4 4 4 4 2 2 2 2 5 5 5 5 5 5 5 5 5 5 5 5 5 5 5 5 5 5 5 5 5 5 5 5 5 5 5 5 5 5 2 2 6 6 6 6 6 6 6 6 6 6 6 6 3 4 4 
4 4 4 4 4 2 2 2 2 6 6 5 6 5 5 6 6 5 5 6 6 5 5 6 6 6 6 6 5 5 6 6 6 6 5 5 6 6 6 2 2 6 6 6 6 6 6 6 6 6 6 6 6 3 4 4 
4 4 3 3 3 3 3 3 3 6 6 5 5 5 5 6 5 5 5 6 5 5 5 6 6 6 5 6 5 5 6 6 5 6 5 5 6 6 6 2 2 6 6 6 6 6 6 6 6 6 6 6 6 3 4 4 
4 4 3 6 6 6 6 6 6 6 6 6 6 6 6 6 6 6 6 6 6 6 6 6 6 6 6 6 6 6 6 6 6 6 6 6 6 6 6 2 2 6 6 6 6 6 6 6 6 6 6 6 6 3 4 4 
4 4 3 6 6 6 6 6 6 6 6 6 6 6 6 6 6 6 6 6 6 6 6 6 6 6 6 6 6 6 6 6 6 6 6 6 6 6 6 2 2 6 6 6 6 6 6 6 6 6 6 6 6 3 4 4 
4 4 3 6 6 6 6 6 6 6 6 3 3 3 3 3 3 3 3 3 3 3 6 3 3 3 3 3 3 3 3 3 3 3 3 3 3 3 3 3 3 3 3 3 3 6 6 6 6 6 6 6 6 3 4 4 
4 4 3 6 6 6 6 6 6 6 6 3 -1 -1 -1 -1 -1 -1 -1 -1 4 4 6 3 -1 -1 -1 -1 -1 -1 -1 -1 -1 -1 -1 -1 -1 -1 -1 -1 -1 -1 -1 -1 3 6 6 6 6 6 6 6 6 3 4 4 
4 4 3 6 6 6 6 6 6 6 6 3 9 -1 8 -1 8 -1 8 -1 4 4 6 3 9 -1 8 -1 8 -1 8 -1 8 -1 8 -1 8 -1 8 -1 8 -1 12 -1 3 6 6 6 6 6 6 6 6 3 4 4 
4 4 3 6 6 6 6 6 6 6 6 3 -1 -1 -1 -1 -1 -1 -1 -1 4 4 6 3 -1 -1 -1 -1 -1 -1 -1 -1 -1 -1 -1 -1 -1 -1 -1 -1 -1 -1 -1 -1 3 6 6 6 6 6 6 6 6 3 4 4 
4 4 3 6 6 6 6 6 6 6 6 3 7 -1 9 -1 8 -1 8 -1 4 4 6 3 7 -1 9 -1 8 -1 8 -1 8 -1 8 -1 8 -1 8 -1 12 -1 7 -1 3 6 6 6 6 6 6 6 6 3 4 4 
4 4 3 6 6 6 6 6 6 6 6 3 -1 -1 -1 -1 3 3 3 3 3 3 6 3 -1 -1 -1 -1 3 3 3 3 3 3 3 3 3 3 3 3 -1 -1 -1 -1 3 6 6 6 6 6 6 6 6 3 4 4 
4 4 3 3 3 3 3 3 3 3 3 3 7 -1 7 -1 3 6 6 6 6 6 6 3 7 -1 7 -1 3 6 6 6 6 6 6 6 6 6 6 3 7 -1 7 -1 3 3 3 3 3 3 3 3 3 3 4 4 
4 4 4 4 4 4 4 4 4 4 3 3 24 -1 24 -1 3 3 3 3 3 3 3 3 24 24 24 -1 3 3 3 3 3 3 3 3 3 3 3 3 24 -1 24 -1 3 3 4 4 4 4 4 4 4 4 4 4 
4 4 4 4 4 4 4 4 4 4 3 3 24 -1 24 -1 3 3 3 3 3 3 3 3 24 -1 24 -1 3 3 3 3 3 3 3 3 3 3 3 3 24 -1 24 -1 3 3 4 4 4 4 4 4 4 4 4 4 
4 4 3 3 3 3 3 3 3 3 3 3 -1 -1 -1 -1 3 6 6 6 6 6 6 3 -1 -1 -1 -1 3 6 6 6 6 6 6 6 6 6 6 3 -1 -1 -1 -1 3 3 3 3 3 3 3 3 3 3 4 4 
4 4 3 6 6 6 6 6 6 6 6 3 7 -1 7 -1 3 6 6 6 6 6 6 3 7 -1 7 -1 3 6 6 6 6 6 6 6 6 6 6 3 7 -1 7 -1 3 6 6 6 6 6 6 6 6 3 4 4 
4 4 3 6 6 6 6 6 6 6 6 3 -1 -1 -1 -1 3 6 6 6 6 6 6 3 -1 -1 -1 -1 3 6 6 6 6 6 6 6 6 6 6 3 -1 -1 -1 -1 3 6 6 6 6 6 6 6 6 3 4 4 
4 4 3 3 3 3 3 3 3 3 3 3 7 -1 7 -1 3 6 6 6 6 6 6 3 7 -1 7 -1 3 6 6 6 6 6 6 6 6 6 6 3 7 -1 7 -1 3 3 3 3 3 3 3 3 3 3 4 4 
4 4 4 4 4 4 4 4 4 4 3 3 24 -1 24 -1 3 3 3 3 3 3 3 3 24 -1 24 -1 3 3 3 3 3 3 3 3 3 3 3 3 24 -1 24 -1 3 3 4 4 4 4 4 4 4 4 4 4 
4 4 4 4 4 4 4 4 4 4 3 3 24 -1 24 -1 3 3 3 3 3 3 3 3 24 -1 24 -1 3 3 3 3 3 3 3 3 3 3 3 3 24 -1 24 -1 3 3 4 4 4 4 4 4 4 4 4 4 
4 4 3 3 3 3 3 3 3 3 3 3 -1 -1 -1 -1 3 6 6 6 6 6 6 3 -1 -1 -1 -1 3 6 6 6 6 6 6 6 6 6 6 3 -1 -1 -1 -1 3 3 3 3 3 3 3 3 3 3 4 4 
4 4 3 6 6 6 6 6 6 6 6 3 7 -1 7 -1 3 6 6 6 6 6 6 3 7 -1 7 -1 3 6 6 6 6 6 6 6 6 6 6 3 7 -1 7 -1 3 6 6 6 6 6 6 6 6 3 4 4 
4 4 3 6 6 6 6 6 6 6 6 3 -1 -1 -1 -1 3 6 6 6 6 6 6 3 -1 -1 -1 -1 3 6 6 6 6 6 6 6 6 6 6 3 -1 -1 -1 -1 3 6 6 6 6 6 6 6 6 3 4 4 
4 4 3 6 6 6 6 6 6 6 6 3 7 -1 7 -1 3 6 6 6 6 6 6 3 7 -1 7 -1 3 6 6 6 6 6 2 2 2 2 6 3 7 -1 7 -1 3 6 6 6 6 6 6 6 6 3 4 4 
4 4 3 6 6 6 6 6 6 6 6 3 -1 -1 -1 -1 3 6 6 6 6 6 6 3 -1 -1 -1 -1 3 6 6 6 6 6 2 2 2 2 6 3 -1 -1 -1 -1 3 6 6 6 6 6 6 6 6 3 4 4 
4 4 3 6 6 6 6 6 6 6 6 3 7 -1 7 -1 3 3 3 3 3 3 3 3 7 -1 7 -1 3 6 6 6 3 3 3 3 3 3 3 3 7 -1 7 -1 3 6 6 6 6 6 6 6 6 3 4 4 
4 4 3 6 6 6 6 6 6 6 6 3 -1 -1 -1 -1 -1 -1 -1 -1 -1 -1 -1 -1 -1 -1 -1 -1 3 6 6 6 5 5 -1 -1 -1 -1 -1 -1 -1 -1 -1 -1 3 6 6 6 6 6 6 6 6 3 4 4 
4 4 3 6 6 6 6 6 6 6 6 3 7 -1 10 -1 8 -1 8 -1 8 -1 8 -1 11 -1 7 -1 3 6 6 6 5 5 8 -1 8 -1 8 -1 11 -1 7 -1 3 6 6 6 6 6 6 6 6 3 4 4 
4 4 3 6 6 6 6 6 6 6 6 3 -1 -1 -1 -1 -1 -1 -1 -1 -1 -1 -1 -1 -1 -1 -1 -1 3 6 6 6 5 5 -1 -1 -1 -1 -1 -1 -1 -1 -1 -1 3 6 6 6 6 6 6 6 6 3 4 4 
4 4 3 6 6 6 6 6 6 6 6 3 10 -1 8 -1 8 -1 8 -1 8 -1 8 -1 8 -1 11 -1 3 6 6 6 5 5 8 -1 8 -1 8 -1 8 -1 11 -1 3 6 6 6 6 6 6 6 6 3 4 4 
4 4 3 6 6 6 6 6 6 6 6 3 3 3 3 3 3 3 3 3 3 3 3 3 3 3 3 3 3 6 6 6 3 3 3 3 3 3 3 3 3 3 3 3 3 6 6 6 6 6 6 6 6 3 4 4 
4 4 3 6 6 6 6 6 6 6 6 6 6 6 6 6 6 6 6 6 6 6 6 6 6 6 6 6 6 6 6 6 6 6 6 6 6 6 6 6 6 6 6 6 6 6 6 6 6 6 6 6 6 3 4 4 
4 4 3 6 6 6 6 6 6 6 6 6 6 6 6 6 6 6 6 6 6 6 6 6 6 6 6 6 6 6 6 6 6 6 6 6 6 6 6 6 6 6 6 6 6 6 6 6 6 6 6 6 6 3 4 4 
4 4 3 6 6 6 6 6 6 6 6 6 6 6 6 6 6 6 6 6 6 6 6 6 6 6 6 6 6 6 6 6 6 6 6 6 6 6 6 6 6 6 6 6 6 6 6 6 6 6 6 6 6 3 4 4 
4 4 3 6 6 6 6 6 6 6 6 6 6 6 6 6 6 6 6 6 6 6 6 6 6 6 6 6 6 6 6 6 6 6 6 6 6 6 6 6 6 6 6 6 6 6 6 6 6 6 6 6 6 3 4 4 
4 4 3 6 6 6 6 6 6 6 6 6 6 6 6 6 6 6 6 6 6 6 6 6 6 6 6 6 6 6 6 6 6 6 6 6 6 6 6 2 2 2 2 2 2 6 6 6 6 6 6 6 6 3 4 4 
4 4 3 6 6 6 6 6 6 6 6 6 6 6 6 6 6 6 6 6 6 6 6 6 6 6 6 6 6 6 6 6 6 6 6 6 6 6 6 2 2 2 2 2 2 6 6 6 6 6 6 6 6 3 4 4 
4 4 3 6 6 6 6 6 6 6 6 6 6 6 6 6 6 6 6 6 6 6 6 6 6 6 6 6 6 6 6 6 6 6 6 6 6 6 6 2 2 2 2 2 2 6 6 6 6 6 6 6 6 3 4 4 
4 4 3 6 6 6 6 6 6 6 6 6 6 6 6 6 6 6 6 6 6 6 6 6 6 6 6 6 6 6 6 6 6 6 6 6 6 6 6 2 2 2 2 2 2 6 6 6 6 6 6 6 6 3 4 4 
4 4 3 6 6 6 6 6 6 6 6 6 6 6 6 6 6 6 6 6 6 6 6 6 6 6 6 6 6 6 6 6 6 6 6 6 6 6 6 6 6 3 4 4 3 6 6 6 6 6 6 6 6 3 4 4 
4 4 3 6 6 6 6 6 6 6 6 6 6 6 6 6 6 6 6 6 6 6 6 6 6 6 6 6 6 6 6 6 6 6 6 6 6 6 6 6 6 3 4 4 3 6 6 6 6 6 6 6 6 3 4 4 
4 4 3 6 6 6 6 6 6 6 6 6 6 6 6 6 6 6 6 6 6 6 6 6 6 6 6 6 6 6 6 6 6 6 6 6 6 6 6 6 6 3 4 4 3 6 6 6 6 6 6 6 6 3 4 4 
4 4 3 6 6 6 6 6 6 6 6 6 6 6 6 6 6 6 6 6 6 6 6 6 6 6 6 6 6 6 6 6 6 6 6 6 6 6 6 6 6 3 4 4 3 6 6 6 6 6 6 6 6 3 4 4 
4 4 3 3 3 3 3 3 3 3 3 3 3 3 3 3 3 3 3 3 3 3 3 3 3 3 3 3 3 3 3 3 3 3 3 3 3 3 3 3 3 3 4 4 3 3 3 3 3 3 3 3 3 3 4 4 
4 4 4 4 4 4 4 4 4 4 4 4 4 4 4 4 4 4 4 4 4 4 4 4 4 4 4 4 4 4 4 4 4 4 4 4 4 4 4 4 4 4 4 4 4 4 4 4 4 4 4 4 4 4 4 4 
4 4 4 4 4 4 4 4 4 4 4 4 4 4 4 4 4 4 4 4 4 4 4 4 4 4 4 4 4 4 4 4 4 4 4 4 4 4 4 4 4 4 4 4 4 4 4 4 4 4 4 4 4 4 4 4 
