object
col 56
row 56
-1 -1 -1 -1 -1 -1 -1 -1 -1 -1 -1 -1 -1 -1 -1 -1 -1 -1 -1 -1 -1 -1 -1 -1 -1 -1 -1 -1 -1 -1 -1 -1 -1 -1 -1 -1 -1 -1 -1 -1 -1 -1 -1 -1 -1 -1 -1 -1 -1 -1 -1 -1 -1 -1 -1 -1 
-1 -1 -1 -1 -1 -1 -1 -1 -1 -1 -1 -1 -1 -1 -1 -1 -1 -1 -1 -1 -1 -1 -1 -1 -1 -1 -1 -1 -1 -1 -1 -1 -1 -1 -1 -1 -1 -1 -1 -1 -1 -1 -1 -1 -1 -1 -1 -1 -1 -1 -1 -1 -1 -1 -1 -1 
-1 -1 -1 -1 -1 -1 -1 -1 -1 106 -1 -1 -1 -1 -1 -1 -1 -1 106 -1 -1 -1 -1 101 -1 -1 -1 106 -1 -1 -1 -1 -1 -1 -1 -1 106 -1 -1 -1 -1 -1 -1 -1 -1 106 -1 -1 -1 -1 -1 -1 -1 -1 -1 -1 
-1 -1 -1 -1 -1 -1 -1 -1 -1 -1 -1 -1 -1 -1 -1 -1 -1 -1 -1 -1 -1 -1 -1 -1 -1 -1 -1 -1 -1 -1 -1 -1 -1 -1 -1 -1 -1 -1 -1 -1 -1 -1 -1 -1 -1 -1 -1 -1 -1 -1 -1 -1 -1 106 -1 -1 
-1 -1 106 -1 -1 -1 -1 -1 -1 -1 -1 -1 -1 -1 -1 -1 -1 -1 -1 -1 -1 -1 -1 -1 -1 -1 -1 -1 -1 -1 -1 -1 -1 -1 -1 -1 -1 -1 -1 -1 -1 -1 92 97 97 97 97 97 97 97 97 97 97 97 -1 -1 
-1 -1 -1 -1 -1 -1 50 -1 -1 34 -1 -1 -1 -1 -1 -1 -1 -1 -1 -1 -1 -1 -1 -1 -1 -1 -1 -1 -1 -1 -1 -1 -1 -1 -1 -1 -1 -1 -1 -1 -1 -1 98 -1 -1 -1 -1 -1 -1 -1 -1 -1 -1 -1 -1 -1 
-1 -1 -1 -1 -1 -1 50 -1 -1 -1 -1 -1 -1 -1 -1 40 -1 -1 -1 42 -1 -1 -1 -1 -1 43 -1 -1 -1 -1 -1 -1 -1 -1 43 -1 -1 -1 43 -1 -1 -1 98 -1 86 -1 -1 -1 -1 -1 -1 -1 86 -1 -1 -1 
-1 -1 -1 -1 -1 -1 -1 -1 -1 -1 -1 -1 -1 42 -1 40 -1 41 -1 -1 -1 -1 40 -1 41 -1 43 -1 -1 -1 40 42 42 -1 -1 -1 -1 41 -1 -1 -1 -1 98 -1 -1 -1 -1 -1 -1 -1 -1 -1 -1 -1 -1 -1 
-1 -1 -1 -1 -1 -1 -1 -1 -1 34 -1 -1 -1 41 -1 -1 -1 -1 -1 -1 -1 -1 -1 40 -1 -1 -1 -1 -1 41 -1 -1 -1 41 -1 -1 42 -1 -1 -1 -1 -1 98 -1 86 -1 -1 -1 38 -1 -1 -1 86 -1 -1 -1 
-1 -1 -1 -1 -1 -1 -1 -1 -1 -1 -1 -1 -1 -1 -1 40 -1 42 -1 43 -1 -1 40 -1 42 -1 -1 42 42 -1 43 -1 -1 -1 -1 42 -1 -1 -1 41 -1 -1 98 -1 -1 -1 -1 -1 -1 -1 -1 -1 -1 -1 -1 -1 
-1 -1 -1 -1 -1 -1 -1 -1 -1 -1 -1 -1 -1 42 -1 41 -1 -1 -1 -1 -1 -1 40 -1 -1 -1 -1 -1 -1 -1 -1 -1 -1 41 -1 -1 -1 -1 40 -1 42 -1 92 97 97 97 97 97 97 97 97 97 97 97 -1 -1 
-1 -1 -1 -1 -1 -1 -1 -1 -1 34 -1 -1 -1 -1 -1 -1 -1 -1 -1 -1 -1 -1 -1 -1 -1 -1 -1 -1 -1 -1 -1 -1 -1 -1 -1 -1 -1 41 -1 40 -1 -1 -1 -1 -1 -1 -1 -1 -1 -1 -1 -1 -1 -1 -1 -1 
-1 -1 106 -1 -1 -1 35 -1 -1 -1 -1 -1 -1 -1 -1 -1 -1 -1 -1 -1 -1 -1 -1 -1 -1 -1 -1 -1 -1 -1 -1 -1 -1 -1 -1 -1 -1 41 -1 -1 -1 -1 -1 -1 -1 -1 -1 -1 -1 40 -1 -1 -1 106 -1 -1 
-1 -1 -1 -1 -1 -1 -1 -1 -1 91 97 97 97 97 97 97 97 97 97 97 97 97 97 97 97 97 97 97 97 97 97 97 97 97 97 97 97 97 97 97 97 97 97 97 97 97 91 -1 -1 -1 -1 -1 -1 -1 -1 -1 
-1 -1 -1 -1 42 -1 -1 -1 -1 98 44 -1 35 -1 44 -1 35 -1 44 -1 35 -1 44 -1 35 -1 44 -1 35 -1 44 -1 35 -1 44 -1 35 -1 44 -1 35 -1 44 -1 35 -1 98 -1 -1 -1 42 -1 -1 29 -1 -1 
-1 -1 -1 -1 -1 40 41 -1 -1 98 -1 -1 -1 -1 -1 -1 -1 -1 -1 -1 -1 -1 -1 -1 -1 -1 -1 -1 -1 -1 -1 -1 -1 -1 -1 -1 -1 -1 -1 -1 -1 -1 -1 -1 -1 44 98 -1 -1 40 -1 -1 -1 -1 -1 -1 
-1 -1 27 -1 43 -1 40 -1 -1 98 34 -1 -1 -1 -1 -1 -1 -1 -1 -1 -1 -1 34 -1 -1 -1 -1 -1 -1 -1 -1 -1 -1 -1 -1 -1 -1 -1 -1 -1 -1 -1 -1 -1 -1 -1 98 -1 40 -1 -1 43 -1 37 -1 -1 
-1 -1 27 -1 -1 -1 -1 -1 -1 98 -1 -1 -1 -1 -1 -1 -1 -1 -1 -1 -1 -1 -1 -1 -1 -1 -1 -1 -1 -1 -1 -1 -1 -1 -1 -1 -1 -1 -1 -1 -1 -1 -1 -1 -1 34 98 -1 -1 -1 41 -1 -1 37 -1 -1 
-1 -1 -1 -1 -1 41 40 -1 -1 98 44 -1 -1 -1 -1 -1 -1 -1 -1 -1 -1 -1 39 -1 -1 -1 -1 -1 -1 -1 -1 -1 -1 -1 -1 -1 -1 -1 -1 -1 -1 -1 -1 -1 -1 -1 98 -1 -1 -1 -1 -1 -1 -1 -1 -1 
-1 -1 -1 -1 42 -1 -1 -1 -1 98 -1 -1 -1 -1 -1 -1 -1 -1 -1 -1 -1 -1 34 -1 -1 -1 -1 -1 -1 -1 -1 -1 -1 -1 -1 -1 -1 -1 -1 -1 -1 -1 -1 -1 -1 44 98 -1 -1 -1 42 -1 -1 -1 -1 -1 
-1 -1 -1 -1 -1 -1 43 -1 -1 98 -1 -1 -1 -1 -1 -1 -1 -1 -1 -1 -1 -1 -1 -1 -1 -1 -1 -1 -1 -1 -1 -1 -1 -1 -1 -1 -1 -1 -1 -1 -1 -1 -1 -1 -1 -1 98 -1 -1 40 -1 -1 -1 -1 -1 -1 
-1 -1 106 -1 -1 -1 -1 -1 -1 98 93 -1 -1 -1 -1 -1 -1 35 -1 35 -1 35 39 -1 -1 -1 -1 -1 -1 35 -1 35 -1 35 -1 35 -1 35 -1 -1 -1 -1 -1 -1 -1 34 98 -1 -1 -1 -1 -1 -1 106 -1 -1 
-1 -1 -1 -1 -1 -1 -1 -1 -1 96 -1 -1 -1 -1 -1 -1 -1 -1 -1 -1 -1 -1 -1 -1 -1 -1 -1 -1 -1 -1 -1 -1 -1 -1 -1 -1 -1 -1 -1 -1 -1 -1 -1 -1 -1 -1 96 -1 -1 -1 -1 -1 -1 -1 -1 -1 
-1 -1 -1 -1 -1 -1 -1 -1 -1 96 -1 -1 -1 -1 -1 -1 -1 -1 -1 -1 -1 -1 -1 -1 -1 -1 -1 -1 -1 -1 -1 -1 -1 -1 -1 -1 -1 -1 -1 -1 -1 -1 -1 -1 -1 -1 96 -1 -1 -1 -1 -1 -1 -1 -1 -1 
-1 -1 -1 -1 -1 -1 -1 -1 -1 98 44 -1 -1 -1 -1 -1 -1 -1 -1 -1 -1 -1 102 -1 -1 -1 -1 -1 -1 -1 26 26 -1 42 42 -1 26 26 40 -1 -1 -1 -1 -1 -1 -1 98 -1 -1 -1 41 -1 -1 -1 -1 -1 
-1 -1 32 -1 -1 42 -1 41 -1 98 -1 -1 -1 -1 -1 -1 -1 -1 87 -1 87 -1 -1 -1 -1 -1 -1 -1 -1 34 -1 -1 -1 -1 -1 -1 -1 -1 -1 -1 -1 -1 -1 -1 -1 44 98 -1 40 -1 41 -1 -1 102 -1 -1 
-1 -1 102 -1 42 -1 41 -1 -1 98 34 -1 -1 -1 -1 -1 -1 -1 -1 -1 -1 -1 35 -1 -1 -1 -1 -1 -1 -1 -1 -1 -1 -1 -1 -1 -1 -1 34 -1 -1 -1 -1 -1 -1 -1 98 -1 -1 43 -1 -1 -1 32 -1 -1 
-1 -1 -1 -1 -1 -1 -1 -1 -1 98 -1 -1 -1 -1 -1 -1 -1 106 -1 32 -1 -1 106 -1 -1 -1 -1 -1 -1 106 36 40 97 35 97 36 40 97 106 -1 -1 -1 -1 -1 -1 34 98 -1 -1 -1 -1 40 -1 -1 -1 -1 
-1 -1 -1 -1 -1 -1 -1 -1 -1 96 -1 -1 -1 -1 -1 -1 -1 -1 -1 -1 -1 -1 -1 -1 -1 -1 -1 -1 -1 -1 -1 -1 -1 -1 -1 -1 -1 -1 -1 -1 -1 -1 -1 -1 -1 -1 96 -1 -1 -1 -1 -1 -1 -1 -1 -1 
-1 -1 -1 -1 -1 -1 -1 -1 -1 96 -1 -1 -1 -1 -1 -1 -1 -1 -1 -1 -1 -1 -1 -1 -1 -1 -1 -1 -1 -1 -1 -1 -1 -1 -1 -1 -1 -1 -1 -1 -1 -1 -1 -1 -1 -1 96 -1 -1 -1 -1 -1 -1 -1 -1 -1 
-1 -1 106 -1 -1 -1 -1 -1 -1 98 44 -1 -1 -1 -1 -1 -1 106 29 -1 -1 -1 106 -1 -1 -1 -1 -1 -1 106 35 97 35 97 35 97 35 97 106 -1 -1 -1 -1 -1 -1 -1 98 -1 -1 -1 -1 -1 -1 106 -1 -1 
-1 -1 -1 -1 -1 -1 -1 -1 -1 98 -1 -1 -1 -1 -1 -1 -1 34 -1 -1 -1 -1 34 -1 -1 -1 -1 -1 -1 -1 39 -1 -1 -1 -1 -1 -1 -1 -1 -1 -1 -1 -1 -1 -1 44 98 -1 -1 41 -1 -1 -1 -1 -1 -1 
-1 -1 -1 -1 41 -1 41 41 -1 98 34 -1 -1 -1 -1 -1 -1 92 -1 -1 -1 -1 -1 -1 -1 -1 -1 -1 -1 34 -1 -1 -1 -1 -1 -1 -1 -1 -1 -1 -1 -1 -1 -1 -1 -1 98 -1 -1 -1 -1 -1 -1 -1 -1 -1 
-1 -1 -1 -1 -1 41 -1 -1 -1 98 -1 -1 -1 -1 -1 -1 -1 -1 32 -1 -1 -1 93 -1 -1 -1 -1 -1 -1 -1 34 -1 -1 94 -1 -1 -1 -1 -1 -1 -1 -1 -1 -1 -1 34 98 -1 -1 40 -1 43 -1 -1 -1 -1 
-1 -1 27 -1 -1 -1 -1 -1 -1 98 44 -1 -1 -1 -1 -1 -1 34 43 -1 38 -1 43 -1 -1 -1 -1 -1 -1 34 39 -1 -1 91 -1 110 -1 -1 -1 -1 -1 -1 -1 -1 -1 -1 98 -1 -1 -1 -1 -1 -1 37 -1 -1 
-1 -1 27 -1 -1 40 -1 42 -1 98 -1 -1 -1 -1 -1 -1 -1 -1 -1 -1 -1 -1 -1 -1 -1 -1 -1 -1 -1 -1 34 -1 -1 -1 -1 -1 -1 -1 -1 -1 -1 -1 -1 -1 -1 44 98 -1 -1 -1 40 -1 -1 37 -1 -1 
-1 -1 -1 -1 -1 -1 -1 -1 -1 98 34 -1 -1 -1 -1 -1 -1 -1 -1 -1 -1 -1 -1 -1 -1 -1 -1 -1 -1 34 -1 -1 -1 -1 -1 -1 -1 -1 -1 -1 -1 -1 -1 -1 -1 -1 98 -1 -1 42 -1 -1 -1 -1 -1 -1 
-1 -1 -1 -1 -1 -1 -1 -1 -1 98 -1 -1 -1 -1 -1 -1 -1 -1 -1 -1 -1 -1 -1 -1 -1 -1 -1 -1 -1 -1 39 -1 -1 -1 -1 -1 -1 -1 -1 -1 -1 -1 -1 -1 -1 34 98 -1 -1 43 -1 42 -1 -1 -1 -1 
-1 -1 -1 -1 -1 -1 41 -1 -1 98 44 -1 -1 -1 -1 -1 -1 -1 -1 -1 -1 -1 -1 -1 -1 -1 -1 -1 -1 34 -1 -1 -1 -1 -1 -1 -1 -1 -1 -1 -1 -1 -1 -1 -1 -1 98 -1 -1 -1 -1 -1 -1 -1 -1 -1 
-1 -1 106 -1 -1 40 -1 -1 -1 98 -1 -1 -1 -1 -1 -1 -1 -1 -1 -1 -1 -1 -1 -1 -1 -1 -1 -1 -1 -1 34 -1 -1 -1 -1 -1 -1 -1 -1 -1 -1 -1 -1 -1 -1 44 98 -1 -1 -1 -1 -1 -1 106 -1 -1 
-1 -1 -1 -1 -1 -1 -1 -1 -1 98 34 -1 -1 -1 -1 -1 -1 -1 -1 -1 -1 -1 -1 -1 -1 -1 -1 -1 -1 -1 -1 -1 -1 -1 -1 -1 -1 -1 -1 -1 -1 -1 -1 -1 -1 -1 98 -1 -1 -1 -1 41 -1 -1 -1 -1 
-1 -1 -1 -1 -1 -1 40 -1 -1 98 -1 44 -1 35 -1 44 -1 35 -1 44 -1 35 -1 44 -1 35 -1 44 -1 35 -1 44 -1 35 -1 44 -1 35 -1 44 -1 35 -1 44 -1 34 98 -1 -1 -1 40 -1 -1 -1 -1 -1 
-1 -1 -1 -1 -1 -1 -1 -1 -1 91 97 97 97 97 97 97 97 97 97 97 97 97 97 97 97 97 97 97 97 97 97 97 97 97 97 97 97 97 97 97 97 97 97 97 97 97 91 -1 -1 -1 -1 -1 -1 -1 -1 -1 
-1 -1 -1 -1 -1 -1 -1 -1 -1 -1 -1 -1 -1 -1 -1 -1 -1 -1 -1 -1 -1 -1 -1 -1 -1 -1 -1 -1 -1 -1 -1 -1 -1 -1 -1 -1 -1 -1 -1 -1 -1 -1 -1 -1 -1 -1 -1 -1 -1 -1 42 -1 -1 -1 -1 -1 
-1 -1 -1 -1 42 42 -1 43 43 -1 -1 -1 -1 -1 -1 -1 -1 -1 -1 -1 -1 -1 -1 -1 -1 -1 -1 -1 -1 -1 -1 -1 -1 -1 -1 -1 -1 -1 -1 -1 -1 -1 -1 -1 -1 -1 -1 -1 -1 -1 -1 40 -1 -1 -1 -1 
-1 -1 -1 -1 -1 -1 -1 40 -1 -1 -1 -1 -1 -1 -1 -1 -1 -1 41 -1 -1 -1 -1 -1 -1 -1 -1 -1 -1 -1 -1 -1 -1 -1 -1 -1 -1 -1 -1 -1 -1 -1 -1 -1 -1 -1 -1 -1 -1 -1 42 -1 -1 -1 -1 -1 
-1 -1 -1 -1 -1 42 -1 -1 -1 -1 -1 -1 -1 -1 43 -1 -1 -1 -1 41 -1 41 -1 -1 -1 -1 -1 -1 -1 -1 -1 41 -1 43 -1 -1 -1 -1 -1 -1 -1 -1 -1 -1 -1 -1 -1 -1 -1 -1 -1 42 -1 -1 -1 -1 
-1 -1 -1 -1 -1 -1 -1 41 -1 40 -1 41 -1 -1 -1 43 -1 -1 -1 -1 -1 -1 -1 -1 43 43 -1 41 -1 -1 -1 -1 -1 43 43 -1 -1 -1 -1 -1 113 -1 113 -1 -1 41 41 -1 -1 -1 43 -1 -1 -1 -1 -1 
-1 -1 106 -1 -1 -1 41 -1 -1 -1 -1 -1 42 -1 42 -1 -1 -1 -1 40 -1 40 -1 41 -1 -1 -1 -1 -1 -1 40 -1 40 40 -1 -1 -1 -1 -1 -1 -1 -1 -1 -1 -1 -1 -1 42 -1 40 -1 -1 -1 106 -1 -1 
-1 -1 -1 -1 -1 -1 -1 -1 -1 40 -1 -1 -1 -1 -1 -1 -1 -1 41 -1 -1 -1 -1 41 -1 -1 41 -1 41 -1 40 -1 -1 -1 -1 -1 40 -1 -1 41 -1 -1 -1 -1 -1 -1 -1 -1 42 -1 -1 43 -1 -1 -1 -1 
-1 -1 -1 -1 -1 -1 42 -1 -1 -1 -1 41 -1 -1 -1 -1 -1 -1 -1 -1 42 -1 -1 -1 -1 -1 -1 -1 -1 -1 -1 42 -1 -1 -1 42 -1 -1 42 -1 -1 -1 -1 -1 -1 -1 -1 40 -1 -1 -1 -1 -1 -1 -1 -1 
-1 -1 -1 -1 -1 -1 -1 -1 -1 -1 -1 -1 -1 -1 42 42 -1 -1 -1 -1 42 -1 -1 -1 -1 -1 -1 -1 -1 -1 -1 -1 -1 -1 40 -1 -1 42 -1 -1 -1 -1 -1 -1 -1 -1 -1 -1 -1 -1 -1 -1 -1 -1 -1 -1 
-1 -1 -1 -1 -1 -1 -1 -1 -1 -1 -1 -1 -1 -1 -1 -1 -1 -1 -1 -1 -1 -1 -1 -1 -1 -1 -1 -1 -1 -1 -1 -1 -1 -1 -1 -1 -1 -1 -1 -1 -1 -1 -1 -1 -1 -1 -1 -1 -1 -1 -1 -1 -1 -1 -1 -1 
-1 -1 -1 -1 -1 106 -1 -1 -1 -1 -1 -1 -1 -1 106 -1 -1 -1 -1 -1 -1 -1 -1 106 -1 -1 -1 101 -1 -1 -1 -1 106 -1 -1 -1 -1 -1 -1 -1 -1 106 -1 -1 -1 -1 -1 -1 -1 -1 106 -1 -1 -1 -1 -1 
-1 -1 -1 -1 -1 -1 -1 -1 -1 -1 -1 -1 -1 -1 -1 -1 -1 -1 -1 -1 -1 -1 -1 -1 -1 -1 -1 -1 -1 -1 -1 -1 -1 -1 -1 -1 -1 -1 -1 -1 -1 -1 -1 -1 -1 -1 -1 -1 -1 -1 -1 -1 -1 -1 -1 -1 
-1 -1 -1 -1 -1 -1 -1 -1 -1 -1 -1 -1 -1 -1 -1 -1 -1 -1 -1 -1 -1 -1 -1 -1 -1 -1 -1 -1 -1 -1 -1 -1 -1 -1 -1 -1 -1 -1 -1 -1 -1 -1 -1 -1 -1 -1 -1 -1 -1 -1 -1 -1 -1 -1 -1 -1 
