tile
col 56
row 56
-1 -1 -1 -1 -1 -1 -1 -1 -1 -1 -1 -1 -1 -1 -1 -1 -1 -1 -1 -1 -1 -1 -1 -1 -1 -1 -1 -1 -1 -1 -1 -1 -1 -1 -1 -1 -1 -1 -1 -1 -1 -1 -1 -1 -1 -1 -1 -1 -1 -1 -1 -1 -1 -1 -1 -1 
-1 -1 -1 -1 -1 -1 -1 -1 -1 -1 -1 -1 -1 -1 -1 -1 -1 -1 -1 -1 -1 -1 -1 -1 -1 -1 -1 -1 -1 -1 -1 -1 -1 -1 -1 -1 -1 -1 -1 -1 -1 -1 -1 -1 -1 -1 -1 -1 -1 -1 -1 -1 -1 -1 -1 -1 
-1 -1 -1 -1 -1 -1 -1 -1 -1 -1 -1 -1 -1 -1 -1 -1 -1 -1 -1 -1 -1 -1 -1 -1 -1 -1 -1 -1 -1 -1 -1 -1 -1 -1 -1 -1 -1 -1 -1 -1 -1 -1 -1 -1 -1 -1 -1 -1 -1 -1 -1 -1 -1 -1 -1 -1 
-1 -1 -1 -1 -1 -1 -1 -1 -1 -1 -1 -1 -1 -1 -1 -1 -1 -1 -1 -1 -1 -1 -1 -1 -1 -1 -1 -1 -1 -1 -1 -1 -1 -1 -1 -1 -1 -1 -1 -1 -1 -1 -1 -1 -1 -1 -1 -1 -1 -1 -1 -1 -1 -1 -1 -1 
-1 -1 -1 -1 -1 -1 -1 -1 -1 -1 -1 -1 -1 -1 -1 -1 -1 -1 -1 -1 -1 -1 -1 -1 -1 -1 -1 -1 -1 -1 -1 -1 -1 -1 -1 -1 -1 -1 -1 -1 -1 -1 -1 -1 -1 -1 -1 -1 -1 -1 -1 -1 -1 -1 -1 -1 
-1 -1 -1 -1 -1 -1 -1 -1 -1 -1 -1 -1 -1 -1 -1 -1 -1 -1 6 6 6 6 6 6 6 -1 -1 -1 -1 -1 -1 -1 -1 -1 -1 -1 -1 -1 -1 -1 -1 -1 -1 -1 -1 -1 -1 -1 -1 -1 -1 -1 -1 -1 -1 -1 
-1 -1 -1 -1 -1 -1 -1 -1 -1 -1 -1 -1 -1 -1 -1 -1 -1 -1 6 6 6 6 6 6 6 6 -1 -1 -1 -1 -1 -1 -1 -1 -1 -1 -1 -1 -1 -1 -1 -1 -1 -1 -1 -1 -1 -1 -1 -1 -1 -1 -1 -1 -1 -1 
-1 -1 -1 -1 -1 -1 -1 -1 -1 -1 -1 -1 -1 -1 -1 -1 -1 -1 6 6 6 3 3 6 6 6 -1 -1 -1 -1 -1 -1 -1 -1 -1 -1 -1 -1 -1 -1 -1 -1 -1 -1 -1 -1 -1 -1 -1 -1 -1 -1 -1 -1 -1 -1 
-1 -1 -1 -1 -1 -1 -1 -1 -1 -1 -1 -1 -1 -1 -1 -1 -1 -1 6 6 6 3 3 6 6 6 -1 -1 -1 -1 -1 -1 -1 -1 -1 -1 -1 -1 -1 -1 -1 -1 -1 -1 -1 -1 -1 -1 -1 -1 -1 -1 -1 -1 -1 -1 
-1 -1 -1 -1 -1 -1 -1 -1 -1 6 6 6 6 6 6 6 6 6 6 6 6 3 3 6 6 6 6 6 6 6 6 6 6 6 6 6 6 6 6 6 6 6 6 6 6 6 6 -1 -1 -1 -1 -1 -1 -1 -1 -1 
-1 -1 -1 -1 -1 -1 -1 -1 -1 6 6 6 6 6 6 6 6 6 6 6 6 4 4 6 6 6 6 6 6 6 2 2 2 2 6 6 6 6 6 6 6 6 6 6 6 6 6 -1 -1 -1 -1 -1 -1 -1 -1 -1 
-1 -1 -1 -1 -1 -1 -1 -1 -1 6 6 -1 -1 -1 -1 -1 -1 -1 -1 -1 -1 -1 -1 -1 -1 -1 -1 -1 -1 3 2 2 2 2 6 2 2 2 2 2 2 2 2 2 6 6 6 -1 -1 -1 -1 -1 -1 -1 -1 -1 
-1 -1 -1 -1 -1 -1 -1 -1 -1 6 6 9 -1 8 -1 8 -1 8 -1 8 -1 14 -1 8 -1 8 -1 12 -1 3 2 2 2 2 6 2 2 2 2 2 2 2 2 2 6 6 6 -1 -1 -1 -1 -1 -1 -1 -1 -1 
-1 -1 -1 -1 -1 -1 -1 -1 -1 6 6 -1 -1 3 3 3 3 3 3 3 3 3 3 3 3 3 3 -1 -1 3 2 2 2 2 6 6 6 2 2 2 2 2 2 2 6 6 6 -1 -1 -1 -1 -1 -1 -1 -1 -1 
-1 -1 -1 -1 -1 -1 -1 -1 -1 6 6 7 -1 3 2 2 2 2 2 2 2 2 2 2 2 2 3 7 -1 3 6 2 2 2 6 6 6 2 2 3 3 2 2 6 6 6 6 -1 -1 -1 -1 -1 -1 -1 -1 -1 
-1 -1 -1 -1 -1 -1 -1 -1 -1 6 6 -1 -1 3 2 2 2 2 2 2 2 2 2 2 2 2 3 -1 -1 3 6 2 2 2 2 2 2 2 6 3 3 2 2 6 6 6 6 -1 -1 -1 -1 -1 -1 -1 -1 -1 
-1 -1 -1 -1 -1 -1 -1 -1 -1 6 6 7 -1 3 2 2 6 2 2 2 2 2 2 6 2 2 3 7 -1 3 6 2 2 2 2 2 2 6 6 3 3 2 2 6 6 6 6 -1 -1 -1 -1 -1 -1 -1 -1 -1 
-1 -1 -1 -1 -1 -1 -1 -1 -1 6 6 -1 -1 3 2 2 6 2 2 2 2 2 2 6 2 2 3 -1 -1 3 6 6 6 6 6 2 2 6 6 3 3 2 2 6 6 6 6 -1 -1 -1 -1 -1 -1 -1 -1 -1 
-1 -1 -1 -1 -1 -1 -1 -1 -1 6 6 7 -1 3 2 2 6 2 2 2 2 2 2 6 2 2 3 7 -1 3 5 4 5 6 6 2 2 2 2 2 2 2 2 6 6 6 6 -1 -1 -1 -1 -1 -1 -1 -1 -1 
-1 -1 -1 -1 -1 -1 -1 -1 -1 6 6 -1 -1 3 2 2 2 2 2 2 2 2 2 2 2 2 3 -1 -1 3 4 5 4 6 6 2 2 2 2 2 2 2 2 6 6 6 6 -1 -1 -1 -1 -1 -1 -1 -1 -1 
-1 -1 -1 -1 -1 -1 -1 -1 -1 -1 6 7 -1 3 2 2 2 2 2 2 2 2 2 2 2 2 3 7 -1 3 5 4 5 6 6 6 6 6 6 2 2 6 6 6 6 6 6 -1 -1 -1 -1 -1 -1 -1 -1 -1 
-1 -1 -1 -1 -1 -1 -1 -1 -1 6 6 -1 -1 3 2 2 6 2 2 2 2 2 2 6 2 2 3 24 -1 3 4 5 4 6 6 6 6 6 6 -1 -1 -1 -1 -1 -1 6 6 -1 -1 -1 -1 -1 -1 -1 -1 -1 
-1 -1 -1 -1 -1 -1 -1 -1 -1 6 6 7 -1 3 2 2 6 2 2 2 2 2 2 6 2 2 3 24 -1 3 5 4 5 6 6 6 6 6 6 10 -1 8 -1 12 -1 6 6 -1 -1 -1 -1 -1 -1 -1 -1 -1 
-1 -1 -1 -1 -1 -1 -1 -1 -1 6 6 -1 -1 3 2 2 6 2 2 2 2 2 2 6 2 2 3 -1 -1 3 4 5 4 5 4 5 4 5 4 3 3 3 3 -1 -1 6 6 -1 -1 -1 -1 -1 -1 -1 -1 -1 
-1 -1 -1 -1 -1 -1 -1 -1 -1 6 6 7 -1 3 2 2 2 2 2 2 2 2 2 2 2 2 3 7 -1 3 5 4 5 4 5 4 5 4 5 4 5 4 3 7 -1 6 6 -1 -1 -1 -1 -1 -1 -1 -1 -1 
-1 -1 -1 -1 -1 -1 -1 -1 -1 6 6 -1 -1 3 2 2 2 2 2 2 2 2 2 2 2 2 3 -1 -1 3 4 5 4 5 4 5 4 5 4 5 4 5 3 -1 -1 6 6 -1 -1 -1 -1 -1 -1 -1 -1 -1 
-1 -1 -1 -1 -1 -1 -1 -1 -1 6 6 7 -1 3 3 3 3 3 3 3 3 3 3 3 3 3 3 7 -1 3 3 3 3 3 3 3 3 3 3 3 3 3 3 7 -1 6 6 -1 -1 -1 -1 -1 -1 -1 -1 -1 
-1 -1 -1 -1 -1 -1 -1 -1 -1 6 6 -1 -1 3 3 3 3 3 3 3 3 3 3 3 3 3 3 -1 -1 -1 -1 -1 -1 -1 -1 -1 -1 -1 -1 -1 -1 -1 -1 -1 -1 6 6 -1 -1 -1 -1 -1 -1 -1 -1 -1 
-1 -1 -1 -1 -1 -1 -1 -1 -1 6 6 7 -1 6 6 6 6 6 6 3 3 6 6 6 6 6 6 16 -1 8 -1 8 -1 8 -1 8 -1 8 -1 25 25 8 -1 11 -1 6 6 -1 -1 -1 -1 -1 -1 -1 -1 -1 
-1 -1 -1 -1 -1 -1 -1 -1 -1 6 6 -1 -1 6 6 6 6 6 6 3 3 6 6 6 6 6 6 -1 -1 3 3 3 3 3 3 3 3 3 3 3 3 3 3 3 3 6 6 -1 -1 -1 -1 -1 -1 -1 -1 -1 
-1 -1 -1 -1 -1 -1 -1 -1 -1 6 6 7 -1 6 6 3 3 3 3 3 3 3 3 3 3 6 6 7 -1 3 4 5 4 5 4 5 4 5 4 5 4 5 4 5 3 6 6 -1 -1 -1 -1 -1 -1 -1 -1 -1 
-1 -1 -1 -1 -1 -1 -1 -1 -1 6 6 -1 -1 6 6 3 3 3 3 3 3 3 3 3 3 6 6 -1 -1 3 5 6 6 6 6 6 6 6 6 6 6 6 6 4 3 6 6 -1 -1 -1 -1 -1 -1 -1 -1 -1 
-1 -1 -1 -1 -1 -1 -1 -1 -1 6 6 7 -1 6 6 3 3 3 3 3 3 3 3 3 3 6 6 7 -1 3 4 6 6 6 6 6 6 6 6 6 6 6 6 5 3 6 6 -1 -1 -1 -1 -1 -1 -1 -1 -1 
-1 -1 -1 -1 -1 -1 -1 -1 -1 6 6 -1 -1 6 6 3 3 6 6 6 6 6 3 3 3 6 6 -1 -1 3 5 6 6 6 6 6 6 6 6 6 6 6 6 4 3 6 6 -1 -1 -1 -1 -1 -1 -1 -1 -1 
-1 -1 -1 -1 -1 -1 -1 -1 -1 6 6 7 -1 6 6 3 3 6 6 6 6 6 3 3 3 6 6 7 -1 3 4 6 6 6 6 6 6 6 6 6 6 6 6 5 3 6 6 -1 -1 -1 -1 -1 -1 -1 -1 -1 
-1 -1 -1 -1 -1 -1 -1 -1 -1 6 6 24 -1 3 3 3 3 6 6 6 6 6 3 3 3 3 3 24 -1 3 5 6 6 6 6 6 6 6 6 6 6 6 6 4 3 6 6 -1 -1 -1 -1 -1 -1 -1 -1 -1 
-1 -1 -1 -1 -1 -1 -1 -1 -1 6 6 24 -1 3 3 3 3 6 6 6 6 6 3 3 3 3 3 24 -1 3 4 6 6 6 6 6 6 6 6 6 6 6 6 5 3 6 6 -1 -1 -1 -1 -1 -1 -1 -1 -1 
-1 -1 -1 -1 -1 -1 -1 -1 -1 6 6 -1 -1 6 6 3 3 6 6 6 6 6 3 3 3 6 6 -1 -1 3 5 6 6 6 6 6 6 6 6 6 6 6 6 4 3 6 6 -1 -1 -1 -1 -1 -1 -1 -1 -1 
-1 -1 -1 -1 -1 -1 -1 -1 -1 6 6 7 -1 6 6 3 3 3 3 3 3 3 3 3 3 6 6 7 -1 3 4 6 6 6 6 6 6 6 6 6 6 6 6 5 3 6 6 -1 -1 -1 -1 -1 -1 -1 -1 -1 
-1 -1 -1 -1 -1 -1 -1 -1 -1 6 6 -1 -1 6 6 3 3 3 3 3 3 3 3 3 3 6 6 -1 -1 3 5 6 6 6 6 6 6 6 6 6 6 6 6 4 3 6 6 -1 -1 -1 -1 -1 -1 -1 -1 -1 
-1 -1 -1 -1 -1 -1 -1 -1 -1 6 6 7 -1 6 6 3 3 3 3 3 3 3 3 3 3 6 6 7 -1 3 4 6 6 6 6 6 6 6 6 6 6 6 6 5 3 6 6 -1 -1 -1 -1 -1 -1 -1 -1 -1 
-1 -1 -1 -1 -1 -1 -1 -1 -1 6 6 -1 -1 6 6 6 6 6 6 3 3 6 6 6 6 6 6 -1 -1 3 5 6 6 2 2 2 2 2 2 2 2 6 6 4 3 6 6 -1 -1 -1 -1 -1 -1 -1 -1 -1 
-1 -1 -1 -1 -1 -1 -1 -1 -1 6 6 7 -1 6 6 6 6 6 6 3 3 6 6 6 6 6 6 7 -1 3 4 2 2 2 2 2 2 2 2 2 2 2 2 5 3 6 6 -1 -1 -1 -1 -1 -1 -1 -1 -1 
-1 -1 -1 -1 -1 -1 -1 -1 -1 6 6 -1 -1 -1 -1 -1 -1 -1 -1 -1 -1 -1 -1 -1 -1 -1 -1 -1 -1 3 5 2 2 2 2 2 2 2 2 2 2 2 2 4 3 6 6 -1 -1 -1 -1 -1 -1 -1 -1 -1 
-1 -1 -1 -1 -1 -1 -1 -1 -1 6 6 10 -1 8 -1 8 -1 8 -1 25 25 8 -1 8 -1 8 -1 11 -1 3 3 3 3 3 3 3 3 3 3 3 3 3 3 3 3 6 6 -1 -1 -1 -1 -1 -1 -1 -1 -1 
-1 -1 -1 -1 -1 -1 -1 -1 -1 6 6 6 6 6 6 6 6 6 6 6 6 6 6 6 6 6 6 6 6 6 6 6 6 6 6 6 6 6 6 6 6 6 6 6 6 6 6 -1 -1 -1 -1 -1 -1 -1 -1 -1 
-1 -1 -1 -1 -1 -1 -1 -1 -1 6 6 6 6 6 6 6 6 6 6 6 6 6 6 6 6 6 6 6 6 6 6 6 6 6 6 6 6 6 6 6 6 6 6 6 6 6 6 -1 -1 -1 -1 -1 -1 -1 -1 -1 
-1 -1 -1 -1 -1 -1 -1 -1 -1 -1 -1 -1 -1 -1 -1 -1 -1 -1 -1 -1 -1 -1 -1 -1 -1 -1 -1 -1 -1 -1 -1 -1 -1 -1 -1 -1 -1 -1 -1 -1 -1 -1 -1 -1 -1 -1 -1 -1 -1 -1 -1 -1 -1 -1 -1 -1 
-1 -1 -1 -1 -1 -1 -1 -1 -1 -1 -1 -1 -1 -1 -1 -1 -1 -1 -1 -1 -1 -1 -1 -1 -1 -1 -1 -1 -1 -1 -1 -1 -1 -1 -1 -1 -1 -1 -1 -1 -1 -1 -1 -1 -1 -1 -1 -1 -1 -1 -1 -1 -1 -1 -1 -1 
-1 -1 -1 -1 -1 -1 -1 -1 -1 -1 -1 -1 -1 -1 -1 -1 -1 -1 -1 -1 -1 -1 -1 -1 -1 -1 -1 -1 -1 -1 -1 -1 -1 -1 -1 -1 -1 -1 -1 -1 -1 -1 -1 -1 -1 -1 -1 -1 -1 -1 -1 -1 -1 -1 -1 -1 
-1 -1 -1 -1 -1 -1 -1 -1 -1 -1 -1 -1 -1 -1 -1 -1 -1 -1 -1 -1 -1 -1 -1 -1 -1 -1 -1 -1 -1 -1 -1 -1 -1 -1 -1 -1 -1 -1 -1 -1 -1 -1 -1 -1 -1 -1 -1 -1 -1 -1 -1 -1 -1 -1 -1 -1 
-1 -1 -1 -1 -1 -1 -1 -1 -1 -1 -1 -1 -1 -1 -1 -1 -1 -1 -1 -1 -1 -1 -1 -1 -1 -1 -1 -1 -1 -1 -1 -1 -1 -1 -1 -1 -1 -1 -1 -1 -1 -1 -1 -1 -1 -1 -1 -1 -1 -1 -1 -1 -1 -1 -1 -1 
-1 -1 -1 -1 -1 -1 -1 -1 -1 -1 -1 -1 -1 -1 -1 -1 -1 -1 -1 -1 -1 -1 -1 -1 -1 -1 -1 -1 -1 -1 -1 -1 -1 -1 -1 -1 -1 -1 -1 -1 -1 -1 -1 -1 -1 -1 -1 -1 -1 -1 -1 -1 -1 -1 -1 -1 
-1 -1 -1 -1 -1 -1 -1 -1 -1 -1 -1 -1 -1 -1 -1 -1 -1 -1 -1 -1 -1 -1 -1 -1 -1 -1 -1 -1 -1 -1 -1 -1 -1 -1 -1 -1 -1 -1 -1 -1 -1 -1 -1 -1 -1 -1 -1 -1 -1 -1 -1 -1 -1 -1 -1 -1 
-1 -1 -1 -1 -1 -1 -1 -1 -1 -1 -1 -1 -1 -1 -1 -1 -1 -1 -1 -1 -1 -1 -1 -1 -1 -1 -1 -1 -1 -1 -1 -1 -1 -1 -1 -1 -1 -1 -1 -1 -1 -1 -1 -1 -1 -1 -1 -1 -1 -1 -1 -1 -1 -1 -1 -1 
-1 -1 -1 -1 -1 -1 -1 -1 -1 -1 -1 -1 -1 -1 -1 -1 -1 -1 -1 -1 -1 -1 -1 -1 -1 -1 -1 -1 -1 -1 -1 -1 -1 -1 -1 -1 -1 -1 -1 -1 -1 -1 -1 -1 -1 -1 -1 -1 -1 -1 -1 -1 -1 -1 -1 -1 
