object
col 56
row 56
45 45 45 45 45 45 45 45 45 45 45 45 45 45 45 45 45 45 45 45 45 45 45 45 45 45 45 45 45 45 45 45 45 45 45 45 45 45 -1 -1 45 45 45 -1 -1 -1 -1 -1 96 115 115 -1 115 115 -1 -1 
45 35 97 35 -1 35 35 35 35 35 35 35 97 35 97 45 92 -1 -1 -1 -1 -1 35 35 35 35 -1 45 45 -1 45 45 45 -1 -1 -1 45 -1 -1 -1 -1 45 45 105 -1 -1 -1 -1 96 -1 -1 -1 -1 -1 -1 -1 
98 -1 97 97 -1 34 -1 -1 -1 -1 -1 -1 -1 -1 -1 -1 34 -1 -1 -1 -1 -1 35 35 35 35 -1 45 45 -1 -1 -1 -1 -1 -1 -1 -1 -1 -1 -1 -1 -1 -1 -1 -1 -1 -1 -1 96 -1 -1 -1 -1 100 86 86 
34 -1 -1 105 98 34 -1 -1 -1 -1 -1 -1 -1 -1 -1 32 91 102 70 -1 -1 -1 -1 -1 -1 -1 -1 45 45 -1 108 -1 -1 -1 -1 -1 -1 -1 -1 -1 -1 -1 -1 105 -1 -1 -1 -1 96 28 -1 -1 -1 100 -1 -1 
105 98 112 -1 98 -1 -1 -1 -1 -1 -1 -1 -1 -1 -1 -1 -1 -1 -1 -1 -1 -1 -1 -1 -1 -1 -1 -1 101 -1 -1 -1 -1 45 -1 53 -1 -1 -1 45 -1 -1 -1 -1 -1 -1 -1 -1 105 95 95 72 95 95 95 105 
34 87 88 -1 -1 -1 -1 47 -1 47 -1 47 -1 47 -1 -1 93 -1 91 35 35 35 -1 35 35 91 34 -1 -1 -1 108 -1 -1 45 -1 53 -1 -1 -1 45 55 -1 45 105 -1 -1 -1 -1 -1 -1 -1 -1 -1 -1 -1 -1 
105 87 -1 -1 87 40 -1 -1 -1 -1 -1 -1 -1 -1 -1 -1 34 -1 34 42 -1 35 35 42 -1 -1 34 -1 -1 -1 -1 -1 -1 45 32 53 -1 -1 -1 45 45 45 45 -1 -1 -1 -1 -1 -1 -1 -1 -1 -1 -1 -1 -1 
92 31 102 -1 35 92 97 42 97 35 97 42 97 35 97 42 94 -1 34 32 -1 -1 -1 -1 -1 -1 34 -1 -1 -1 -1 -1 103 45 -1 105 -1 105 -1 45 -1 105 -1 105 -1 -1 -1 -1 -1 -1 -1 -1 -1 -1 -1 -1 
-1 -1 -1 -1 -1 -1 -1 -1 -1 -1 -1 -1 -1 -1 -1 -1 -1 -1 34 31 -1 62 -1 -1 -1 -1 34 -1 -1 -1 -1 -1 35 -1 -1 -1 -1 -1 -1 -1 -1 -1 -1 -1 -1 -1 -1 -1 -1 -1 -1 -1 -1 -1 -1 -1 
109 -1 32 87 -1 87 105 -1 -1 41 35 35 35 40 35 35 35 40 92 35 -1 -1 -1 -1 -1 40 35 35 -1 40 35 35 35 40 35 35 35 40 35 35 35 40 35 35 35 35 91 -1 41 -1 -1 92 35 99 95 95 
34 43 105 97 97 97 97 93 -1 34 -1 -1 -1 -1 -1 -1 -1 -1 -1 -1 -1 -1 -1 -1 -1 -1 -1 -1 -1 -1 -1 -1 -1 -1 35 35 35 35 -1 35 35 -1 -1 -1 35 43 98 -1 98 113 -1 -1 -1 -1 -1 -1 
43 34 34 43 34 43 40 98 -1 34 -1 -1 -1 -1 -1 -1 -1 -1 -1 -1 -1 -1 -1 -1 -1 -1 -1 -1 -1 -1 -1 60 -1 -1 -1 -1 -1 -1 -1 -1 -1 -1 -1 36 -1 34 98 -1 98 -1 -1 33 -1 -1 -1 -1 
43 34 39 34 43 93 34 98 -1 34 -1 -1 -1 -1 -1 -1 -1 -1 -1 -1 -1 -1 -1 -1 -1 -1 -1 -1 -1 -1 -1 -1 -1 -1 -1 -1 -1 -1 -1 -1 -1 -1 37 -1 34 -1 41 -1 98 41 41 41 34 93 95 95 
61 34 40 -1 -1 -1 41 98 -1 41 -1 -1 -1 -1 -1 -1 -1 -1 -1 -1 -1 -1 101 -1 -1 -1 -1 -1 -1 -1 -1 60 -1 -1 34 -1 -1 -1 -1 -1 -1 -1 -1 -1 34 34 98 -1 41 -1 -1 -1 -1 -1 -1 103 
34 42 34 34 40 42 42 98 -1 34 -1 -1 -1 -1 -1 -1 -1 -1 -1 -1 -1 -1 -1 -1 -1 -1 -1 -1 -1 -1 -1 -1 -1 -1 34 35 -1 -1 -1 -1 -1 -1 -1 -1 -1 -1 98 -1 98 -1 -1 -1 -1 -1 -1 -1 
39 34 41 41 -1 39 34 98 -1 34 -1 -1 -1 -1 -1 -1 -1 -1 -1 -1 -1 -1 -1 -1 -1 -1 -1 -1 -1 -1 27 -1 -1 -1 -1 -1 -1 -1 -1 -1 -1 -1 -1 -1 34 -1 98 -1 98 -1 114 -1 -1 104 -1 -1 
61 41 -1 -1 39 39 42 98 -1 34 -1 -1 -1 -1 -1 -1 34 -1 -1 -1 -1 -1 -1 34 -1 -1 -1 -1 -1 -1 27 -1 -1 -1 -1 -1 -1 -1 -1 -1 -1 -1 -1 -1 34 34 41 -1 98 -1 55 -1 -1 -1 -1 -1 
34 43 39 41 43 41 34 98 -1 41 -1 -1 -1 -1 -1 -1 34 -1 -1 -1 -1 -1 -1 34 -1 -1 -1 -1 -1 -1 -1 -1 -1 -1 -1 -1 -1 35 34 -1 -1 -1 -1 -1 -1 -1 98 -1 98 41 41 41 34 -1 -1 -1 
39 34 34 39 -1 34 42 98 -1 34 -1 -1 -1 -1 -1 -1 34 -1 -1 -1 -1 -1 -1 34 -1 -1 -1 -1 -1 -1 -1 -1 -1 -1 34 -1 -1 -1 -1 -1 -1 -1 -1 34 -1 34 98 -1 98 41 35 32 92 -1 -1 -1 
40 40 39 34 39 43 34 98 -1 34 -1 -1 -1 -1 -1 -1 -1 -1 -1 57 -1 -1 -1 -1 -1 -1 -1 -1 -1 -1 -1 -1 -1 -1 34 -1 -1 -1 -1 -1 -1 66 -1 -1 34 -1 98 -1 -1 -1 -1 -1 -1 104 -1 -1 
45 44 97 97 97 97 97 93 -1 34 -1 -1 -1 -1 -1 -1 34 -1 -1 -1 -1 -1 -1 31 -1 -1 -1 -1 -1 -1 -1 -1 -1 -1 40 -1 -1 -1 -1 -1 -1 -1 -1 -1 -1 -1 41 -1 41 -1 58 -1 -1 -1 -1 -1 
45 -1 -1 -1 -1 -1 -1 106 -1 41 -1 -1 -1 -1 -1 -1 34 -1 -1 -1 -1 -1 -1 33 -1 -1 -1 -1 -1 -1 -1 -1 -1 -1 -1 -1 35 -1 -1 -1 -1 -1 -1 -1 -1 -1 98 -1 98 -1 -1 -1 -1 -1 -1 -1 
45 -1 39 -1 42 40 87 -1 -1 34 -1 -1 -1 -1 -1 -1 34 -1 -1 -1 -1 -1 -1 34 -1 -1 -1 -1 -1 -1 -1 -1 -1 36 -1 36 -1 42 -1 -1 -1 -1 -1 -1 -1 -1 98 -1 98 -1 58 -1 -1 -1 -1 -1 
45 -1 -1 39 93 42 -1 -1 -1 34 -1 -1 -1 -1 -1 -1 34 -1 -1 -1 -1 -1 -1 34 -1 -1 -1 -1 -1 -1 -1 -1 -1 -1 -1 -1 -1 -1 -1 -1 -1 -1 -1 -1 -1 -1 98 -1 98 41 -1 -1 -1 104 -1 -1 
45 -1 39 41 -1 -1 87 -1 -1 34 -1 -1 -1 -1 -1 -1 -1 -1 -1 -1 -1 -1 -1 -1 -1 -1 -1 -1 -1 -1 -1 -1 -1 -1 -1 -1 -1 -1 -1 -1 -1 104 -1 -1 -1 -1 41 -1 98 41 58 -1 -1 -1 -1 -1 
45 -1 39 -1 -1 40 -1 -1 -1 41 -1 -1 -1 -1 -1 -1 -1 -1 -1 -1 -1 -1 -1 -1 -1 -1 -1 -1 -1 -1 -1 -1 -1 -1 -1 -1 -1 -1 -1 -1 -1 -1 -1 -1 -1 -1 98 -1 98 41 35 41 92 -1 -1 -1 
45 -1 -1 -1 40 -1 87 106 -1 34 -1 -1 -1 -1 -1 -1 -1 -1 -1 -1 -1 -1 -1 -1 -1 -1 -1 -1 -1 -1 -1 -1 -1 -1 -1 -1 -1 -1 -1 -1 -1 -1 -1 -1 -1 -1 98 -1 98 41 41 41 34 -1 -1 -1 
45 39 39 -1 42 -1 -1 -1 -1 34 -1 -1 -1 -1 -1 -1 -1 -1 -1 -1 -1 -1 -1 -1 -1 -1 102 -1 -1 -1 -1 -1 -1 -1 -1 -1 -1 -1 -1 -1 -1 -1 -1 -1 -1 -1 98 -1 98 41 41 41 -1 104 -1 -1 
45 41 -1 43 -1 -1 41 -1 -1 34 -1 -1 -1 -1 -1 -1 -1 -1 -1 -1 -1 -1 -1 -1 -1 -1 -1 -1 -1 -1 -1 -1 -1 -1 -1 -1 -1 -1 -1 -1 -1 -1 -1 -1 -1 -1 41 -1 98 41 -1 -1 -1 -1 -1 -1 
45 -1 -1 -1 -1 42 41 -1 -1 41 -1 -1 -1 -1 106 35 -1 -1 36 -1 -1 32 -1 40 35 106 -1 -1 -1 -1 -1 -1 -1 -1 -1 -1 -1 -1 -1 -1 -1 -1 -1 -1 -1 -1 98 -1 41 41 69 -1 -1 -1 -1 -1 
45 -1 41 43 -1 43 -1 -1 -1 34 -1 -1 -1 -1 34 -1 -1 -1 -1 -1 -1 -1 -1 -1 -1 -1 -1 -1 -1 -1 -1 -1 -1 -1 -1 -1 -1 -1 -1 -1 -1 -1 -1 -1 -1 -1 98 -1 98 41 41 41 -1 -1 -1 -1 
45 42 -1 -1 -1 -1 -1 106 -1 34 -1 -1 -1 -1 34 -1 -1 -1 -1 -1 -1 -1 -1 -1 -1 34 -1 -1 -1 -1 -1 35 35 35 35 35 35 35 35 35 35 35 35 -1 -1 -1 98 -1 98 41 -1 -1 -1 104 -1 -1 
45 93 -1 42 -1 -1 43 -1 -1 34 -1 -1 -1 -1 102 -1 -1 -1 -1 -1 -1 -1 -1 -1 -1 34 -1 -1 -1 -1 -1 39 -1 -1 -1 -1 -1 -1 -1 -1 -1 39 -1 -1 -1 -1 41 -1 98 41 69 -1 -1 -1 -1 -1 
45 112 -1 -1 68 -1 -1 -1 -1 41 -1 -1 -1 -1 27 -1 -1 91 97 97 97 91 -1 -1 -1 41 -1 -1 -1 -1 -1 39 -1 -1 -1 -1 -1 -1 -1 -1 -1 39 -1 -1 -1 -1 98 -1 98 41 41 41 -1 -1 -1 -1 
45 -1 -1 88 -1 -1 92 -1 -1 34 -1 -1 -1 -1 27 -1 -1 98 -1 -1 -1 98 -1 -1 -1 -1 -1 -1 -1 -1 -1 -1 -1 -1 -1 -1 -1 -1 -1 -1 -1 -1 -1 -1 -1 -1 98 -1 98 -1 -1 96 32 -1 -1 -1 
-1 -1 -1 -1 -1 -1 -1 -1 -1 34 -1 -1 -1 -1 -1 -1 -1 98 -1 -1 -1 98 -1 -1 -1 -1 -1 -1 -1 -1 -1 39 -1 -1 -1 -1 -1 -1 -1 -1 -1 39 -1 -1 -1 -1 98 -1 41 -1 35 92 92 104 -1 -1 
-1 -1 -1 -1 -1 -1 -1 -1 -1 34 -1 -1 -1 -1 -1 -1 -1 98 -1 38 -1 98 -1 -1 -1 -1 -1 -1 -1 -1 -1 39 -1 -1 -1 -1 -1 -1 -1 -1 -1 39 -1 -1 -1 -1 41 -1 98 -1 -1 -1 -1 -1 -1 -1 
-1 -1 -1 -1 -1 -1 -1 -1 -1 41 -1 -1 -1 -1 34 -1 -1 91 97 97 97 91 -1 -1 -1 34 -1 -1 -1 -1 -1 -1 -1 -1 -1 -1 -1 64 -1 -1 -1 -1 -1 -1 -1 -1 98 -1 98 -1 50 -1 -1 -1 -1 -1 
-1 -1 -1 -1 -1 -1 -1 -1 -1 34 -1 -1 -1 -1 -1 -1 -1 -1 -1 -1 -1 -1 -1 -1 -1 -1 -1 -1 -1 -1 -1 39 -1 -1 -1 -1 -1 -1 -1 -1 -1 39 -1 -1 -1 -1 98 -1 98 -1 50 -1 -1 -1 -1 -1 
45 -1 -1 -1 -1 -1 -1 -1 -1 34 -1 -1 -1 -1 34 -1 -1 -1 -1 -1 -1 -1 -1 -1 -1 43 -1 -1 -1 -1 -1 39 -1 -1 -1 -1 -1 -1 -1 -1 -1 39 -1 -1 -1 -1 98 -1 98 -1 50 -1 -1 104 -1 -1 
45 -1 -1 -1 106 -1 -1 -1 -1 34 -1 -1 -1 -1 34 -1 -1 -1 -1 -1 -1 -1 -1 -1 -1 -1 -1 -1 -1 -1 -1 -1 -1 -1 -1 -1 -1 -1 -1 -1 -1 -1 -1 -1 -1 -1 41 -1 98 -1 -1 -1 -1 -1 -1 -1 
45 49 49 -1 -1 -1 -1 -1 -1 41 -1 -1 -1 -1 106 40 -1 26 -1 -1 -1 35 -1 26 26 106 -1 -1 -1 -1 -1 35 35 -1 -1 -1 -1 -1 -1 -1 -1 35 35 -1 -1 -1 98 -1 -1 41 35 -1 -1 -1 -1 -1 
45 -1 -1 -1 -1 -1 -1 -1 -1 34 -1 -1 -1 -1 -1 -1 -1 -1 -1 -1 -1 -1 -1 -1 -1 -1 -1 -1 -1 -1 -1 -1 -1 -1 -1 -1 -1 -1 -1 -1 -1 -1 -1 -1 -1 -1 98 -1 98 -1 97 97 29 -1 -1 -1 
45 -1 -1 -1 -1 -1 -1 -1 -1 34 -1 -1 -1 -1 -1 -1 -1 -1 -1 -1 -1 -1 -1 -1 -1 -1 -1 -1 -1 -1 -1 -1 -1 -1 -1 -1 -1 -1 -1 -1 -1 -1 -1 -1 -1 34 98 -1 98 -1 -1 -1 -1 104 -1 -1 
45 49 49 -1 -1 -1 -1 -1 -1 34 -1 -1 -1 -1 -1 -1 -1 -1 -1 -1 -1 -1 -1 -1 -1 -1 -1 -1 -1 -1 -1 -1 -1 -1 -1 -1 -1 -1 -1 -1 -1 -1 -1 -1 -1 -1 41 -1 98 -1 -1 -1 -1 -1 -1 -1 
45 -1 -1 -1 -1 -1 -1 -1 -1 41 -1 -1 -1 -1 -1 -1 -1 -1 -1 -1 -1 -1 -1 35 -1 -1 -1 -1 -1 -1 -1 -1 -1 -1 -1 -1 -1 -1 -1 -1 -1 -1 -1 -1 -1 -1 98 -1 98 73 -1 -1 -1 -1 -1 -1 
45 -1 -1 -1 32 -1 -1 -1 -1 91 35 35 40 35 35 35 40 35 35 35 40 35 35 35 40 35 35 35 40 93 35 101 40 26 40 93 40 26 40 93 40 26 40 93 40 35 91 -1 41 35 97 97 97 -1 -1 -1 
45 -1 -1 -1 106 -1 -1 -1 -1 -1 -1 -1 -1 -1 -1 -1 -1 -1 -1 -1 -1 -1 -1 -1 -1 -1 -1 -1 -1 -1 32 -1 -1 -1 -1 -1 -1 -1 -1 -1 -1 -1 -1 -1 -1 -1 -1 -1 -1 -1 -1 -1 -1 104 -1 -1 
45 -1 -1 -1 -1 -1 -1 -1 -1 -1 -1 -1 -1 -1 -1 -1 -1 -1 -1 -1 -1 -1 -1 -1 -1 -1 -1 -1 -1 -1 87 -1 87 -1 -1 -1 -1 -1 -1 -1 -1 -1 -1 -1 -1 -1 -1 -1 87 -1 87 -1 87 -1 -1 -1 
45 30 109 -1 -1 -1 -1 -1 -1 -1 117 -1 -1 117 -1 -1 117 -1 -1 117 -1 -1 -1 39 39 39 39 39 39 -1 -1 103 -1 -1 -1 103 -1 -1 -1 103 -1 -1 -1 103 -1 -1 -1 103 -1 -1 -1 103 -1 -1 -1 -1 
45 -1 -1 -1 29 -1 -1 -1 -1 -1 -1 -1 -1 -1 -1 -1 -1 -1 -1 -1 -1 -1 -1 39 94 26 26 32 39 102 -1 -1 -1 -1 -1 -1 -1 -1 -1 -1 -1 -1 -1 -1 -1 -1 -1 -1 -1 -1 -1 -1 -1 -1 -1 -1 
45 -1 -1 87 -1 -1 -1 -1 40 40 103 40 40 103 40 40 103 40 40 103 40 40 103 39 -1 -1 89 -1 -1 -1 -1 -1 -1 -1 -1 -1 -1 -1 -1 -1 -1 -1 -1 -1 -1 -1 -1 -1 -1 -1 -1 -1 -1 -1 -1 -1 
45 -1 -1 -1 -1 -1 -1 -1 -1 -1 -1 -1 -1 -1 -1 -1 -1 -1 -1 -1 -1 -1 -1 39 94 112 -1 -1 -1 104 -1 -1 -1 -1 -1 -1 -1 -1 -1 -1 -1 -1 -1 -1 -1 -1 -1 -1 -1 -1 -1 -1 -1 -1 -1 -1 
45 -1 -1 -1 106 -1 -1 -1 -1 -1 -1 -1 -1 -1 -1 -1 -1 -1 -1 -1 -1 -1 -1 39 94 112 -1 -1 -1 -1 -1 -1 -1 -1 -1 -1 -1 -1 -1 -1 -1 -1 -1 -1 -1 -1 -1 -1 -1 -1 -1 -1 -1 -1 -1 -1 
45 -1 -1 -1 27 -1 42 42 42 42 42 42 42 42 42 42 42 42 42 42 -1 -1 -1 39 94 94 94 94 39 -1 -1 -1 -1 -1 61 -1 -1 -1 61 -1 -1 -1 61 -1 -1 -1 -1 -1 61 -1 -1 -1 61 -1 -1 -1 
45 45 45 45 27 -1 34 34 34 34 34 34 34 34 34 34 34 34 34 42 -1 -1 -1 39 39 39 39 39 39 104 -1 -1 -1 42 97 42 97 42 97 42 97 42 97 42 97 42 97 42 97 42 97 42 97 42 97 91 
